Onyx
An Interactive Fiction
Release 1 / Serial number 160108 / Inform 7 build 6M62 (I6/v6.33 lib 6/12N) SD

Deep Forest
You are lost in a deep forest. The trees grow so close together that you cannot see the sun or the sky, and no grass or small plants thrive on the ground.

>jump
Yeah, you did that once as a kid, on accident. Not  happening again.

>actions
Actions listing on.

>rules
Rules tracing now switched on. Type "rules off" to switch it off again, or "rules all" to include even rules which do not apply.

>jump
[Rule "declare everything initially unmentioned rule" applies.]
[jumping]
[Rule "announce items from multiple object lists rule" applies.]
[Rule "set pronouns from items from multiple object lists rule" applies.]
[Rule "before stage rule" applies.]
[Rule "instead stage rule" applies.]
[Rule "investigate player's awareness before action rule" applies.]
[Rule "player aware of his own actions rule" applies.]
[Rule "check stage rule" applies.]
[Rule "carry out stage rule" applies.]
[Rule "after stage rule" applies.]
[Rule "After jumping" applies.]
Yeah, you did that once as a kid, on accident. Not  happening again.
[jumping - succeeded]

[Rule "A first turn sequence rule" applies.]
[Rule "every turn stage rule" applies.]
[Rule "A last turn sequence rule" applies.]
[Rule "notify score changes rule" applies.]

* * *

>jump
Yeah, you did that once as a kid, on accident. Not  happening again.

>jump
Yeah, you did that once as a kid, on accident. Not  happening again.

>x mouse
STEP OFF M8

* * *

>jump
Yeah, you did that once as a kid, on accident. Not  happening again.

>take mouse
Yeah, you did that once as a kid, on accident. Not  happening again.

* * *

Onyx
An Interactive Fiction
Release 1 / Serial number 160108 / Inform 7 build 6M62 (I6/v6.33 lib 6/12N) SD

Deep Forest
You are lost in a deep forest. The trees grow so close together that you cannot see the sun or the sky, and no grass or small plants thrive on the ground.

>look fence
You see nothing special about the fence.

>x fence
You see nothing special about the fence.

>x mouse
You see nothing special about the mouse.

* * *

Onyx
An Interactive Fiction
Release 1 / Serial number 160108 / Inform 7 build 6M62 (I6/v6.33 lib 6/12N) SD

Deep Forest
You are lost in a deep forest. The trees grow so close together that you cannot see the sun or the sky, and no grass or small plants thrive on the ground.

>look mouse
You see nothing special about mouse.

* * *

Onyx
An Interactive Fiction
Release 1 / Serial number 160108 / Inform 7 build 6M62 (I6/v6.33 lib 6/12N) SD

Deep Forest
You are lost in a deep forest. The trees grow so close together that you cannot see the sun or the sky, and no grass or small plants thrive on the ground.

>take mouse
the tiny mouse EXPLODES AND YOU DIE HAHAHAHA
Taken.

* * *

Onyx
An Interactive Fiction
Release 1 / Serial number 160108 / Inform 7 build 6M62 (I6/v6.33 lib 6/12N) SD

Deep Forest
You are lost in a deep forest. The trees grow so close together that you cannot see the sun or the sky, and no grass or small plants thrive on the ground.

>touch mouse
STEP OFF M8

>actions
Actions listing on.

>take mouse
[taking the tiny mouse]
[(1) jumping]
Yeah, you did that once as a kid, on accident. Not  happening again.
[(1) jumping - failed]

[taking the tiny mouse - failed]

>actions off
Actions listing off.

>rules
Rules tracing now switched on. Type "rules off" to switch it off again, or "rules all" to include even rules which do not apply.

>take mouse
[Rule "declare everything initially unmentioned rule" applies.]
[Rule "announce items from multiple object lists rule" applies.]
[Rule "set pronouns from items from multiple object lists rule" applies.]
[Rule "before stage rule" applies.]
[Rule "instead stage rule" applies.]
[Rule "Instead of taking the mouse" applies.]
[Rule "announce items from multiple object lists rule" applies.]
[Rule "set pronouns from items from multiple object lists rule" applies.]
[Rule "before stage rule" applies.]
[Rule "instead stage rule" applies.]
[Rule "Instead of jumping" applies.]
Yeah, you did that once as a kid, on accident. Not  happening again.

[Rule "A first turn sequence rule" applies.]
[Rule "every turn stage rule" applies.]
[Rule "A last turn sequence rule" applies.]
[Rule "notify score changes rule" applies.]

>actions
[Rule "declare everything initially unmentioned rule" applies.]
Actions listing on.

>take mouse
[Rule "declare everything initially unmentioned rule" applies.]
[taking the tiny mouse]
[Rule "announce items from multiple object lists rule" applies.]
[Rule "set pronouns from items from multiple object lists rule" applies.]
[Rule "before stage rule" applies.]
[Rule "instead stage rule" applies.]
[Rule "Instead of taking the mouse" applies.]
[(1) jumping]
[Rule "announce items from multiple object lists rule" applies.]
[Rule "set pronouns from items from multiple object lists rule" applies.]
[Rule "before stage rule" applies.]
[Rule "instead stage rule" applies.]
[Rule "Instead of jumping" applies.]
Yeah, you did that once as a kid, on accident. Not  happening again.
[(1) jumping - failed]

[taking the tiny mouse - failed]

[Rule "A first turn sequence rule" applies.]
[Rule "every turn stage rule" applies.]
[Rule "A last turn sequence rule" applies.]
[Rule "notify score changes rule" applies.]

* * *

Onyx
An Interactive Fiction
Release 1 / Serial number 160108 / Inform 7 build 6M62 (I6/v6.33 lib 6/12N) SD

Deep Forest
You are lost in a deep forest. The trees grow so close together that you cannot see the sun or the sky, and no grass or small plants thrive on the ground.

>tree
compass (582414) 
  the north
  the northeast
  the northwest
  the south
  the southeast
  the southwest
  the east
  the west
  the up
  the down
  the inside
  the outside
(darkness object) (582446) 
(Inform Parser) (582478) 
(Inform Library) (582510) 
(property_numberspace_forcer) (582542) 
(ValuePropertyHolder_43) (582606) 
(ValuePropertyHolder_47) (582638) 
Deep Forest (583630) 
  yourself
    a magic ball
Baba Yaga's Garden (583662) 
Baba Yaga's Hut (583694) 
  a gigantic mortar
  Baba Yaga
    a magic towel

>w
Baba Yaga's Garden
In this garden grow plants that eat insects and plants that eat birds. It is bordered by a bone fence, and the pavements are made of a giant's kneecaps.

In the center of the garden is Baba Yaga's hut, which walks on chicken legs. Currently the hut is squatting on the ground.

>e
Deep Forest
You are lost in a deep forest. The trees grow so close together that you cannot see the sun or the sky, and no grass or small plants thrive on the ground.

>w
Baba Yaga's Garden
In this garden grow plants that eat insects and plants that eat birds. It is bordered by a bone fence, and the pavements are made of a giant's kneecaps.

In the center of the garden is Baba Yaga's hut, which walks on chicken legs. Currently the hut is squatting on the ground.

>w
You can't go that way.

>tree
compass (582414) 
  the north
  the northeast
  the northwest
  the south
  the southeast
  the southwest
  the east
  the west
  the up
  the down
  the inside
  the outside
(darkness object) (582446) 
(Inform Parser) (582478) 
(Inform Library) (582510) 
(property_numberspace_forcer) (582542) 
(ValuePropertyHolder_43) (582606) 
(ValuePropertyHolder_47) (582638) 
Deep Forest (583630) 
Baba Yaga's Garden (583662) 
  yourself
    a magic ball
Baba Yaga's Hut (583694) 
  a gigantic mortar
  Baba Yaga
    a magic towel

>whome
That's not a verb I recognise.

>showme
Baba Yaga's Garden - room
    yourself - person
        magic ball

>showme self
yourself - person
    magic ball
location: in Baba Yaga's Garden
singular-named, proper-named; unlit, inedible, portable; male
list grouping key: none
printed name: "yourself"
printed plural name: "people"
indefinite article: none
description: "Some people call you Ivan the Fool, but you pay no attention to their rudeness."
initial appearance: none
carrying capacity: 100

* * *

Onyx
An Interactive Fiction
Release 1 / Serial number 160108 / Inform 7 build 6M62 (I6/v6.33 lib 6/12N) SD

Deep Forest
You are lost in a deep forest. The trees grow so close together that you cannot see the sun or the sky, and no grass or small plants thrive on the ground.

>x mouse
WHAT ARE YOU LOOKIN AT 0 PUNK 

The tiny mouse is currently switched off.

>switch on mouse
You switch the tiny mouse on.

>x mouse
WHAT ARE YOU LOOKIN AT 0 PUNK  BRAHWEHOIAWEHFOEHIA 

The tiny mouse is currently switched on.

* * *

>x mouse
WHAT ARE YOU LOOKIN AT 0 PUNK 

The tiny mouse is currently switched off.

>take mouse
Taken.

>x mouse
WHAT ARE YOU LOOKIN AT 0 PUNK  LETME GO 

The tiny mouse is currently switched off.

* * *

>x mouse
WHAT ARE YOU LOOKIN AT 0 PUNK 

The tiny mouse is currently switched off.

>x creature
You can't see any such thing.

* * *

Onyx
An Interactive Fiction
Release 1 / Serial number 160108 / Inform 7 build 6M62 (I6/v6.33 lib 6/12N) SD

Deep Forest
You are lost in a deep forest. The trees grow so close together that you cannot see the sun or the sky, and no grass or small plants thrive on the ground.

>x tiny mouse
WHAT ARE YOU LOOKIN AT 0 PUNK

The tiny mouse is currently switched off.

>switch on mouse
You switch the tiny mouse on.