 

 

Supply Room
You are standing in a spacious room made of reinforced concrete. A lighting panel illuminates the room in a tense white glow. There is another room to the SOUTH.

An alcove is carved into the wall in front of you. Hovering in the alcove are a SHIELD alloy, a BLADE alloy, an ENTROPIC alloy, a MEND alloy and a SPARK alloy.

A large red button labeled RESUPPLY is mounted above the alcove.

I beg your pardon?

>z
Time passes.

>z
Time passes.

>z
Time passes.

HELLO AGAIN! I'D LIKE TO INTRODUCE... THE RATINGS MODULE! HUMAN FEEDBACK IS CRUCIAL TO CREATIVITRIX, AND THIS LITTLE GUY IS HERE TO COLLECT IT! I'LL LET HIM TALK:

 Please rate your experience with the CREATIVITRIX QUALIFICATION DETERMINATION SIMULATION thus far:

5 - Excellent

4 - Appealing

3 - Unremarkable

2 - Lackluster

1 - Truly Awful

>z
Time passes.

>rules
Rules tracing now switched on. Type "rules off" to switch it off again, or "rules all" to include even rules which do not apply.

>z
[Rule "redirect to GEP line input rule" applies.]
[Rule "ordinary checking for content rule" applies.]
[Rule "declare everything initially unmentioned rule" applies.]
[Rule "announce items from multiple object lists rule" applies.]
[Rule "set pronouns from items from multiple object lists rule" applies.]
[Rule "before stage rule" applies.]
[Rule "instead stage rule" applies.]
[Rule "investigate player's awareness before action rule" applies.]
[Rule "player aware of his own actions rule" applies.]
[Rule "check stage rule" applies.]
[Rule "carry out stage rule" applies.]
[Rule "after stage rule" applies.]
[Rule "investigate player's awareness after action rule" applies.]
[Rule "report stage rule" applies.]
[Rule "standard report waiting rule" applies.]
Time passes.
[Rule "last specific action-processing rule" applies.]

[Rule "A first turn sequence rule" applies.]
[Rule "every turn stage rule" applies.]
[Rule "A last turn sequence rule" applies.]
[Rule "notify score changes rule" applies.]

>rules all
[Rule "redirect to GEP line input rule" applies.]
[Rule "ordinary checking for content rule" applies.]
[Rule "declare everything initially unmentioned rule" applies.]
Rules tracing now switched to "all". Type "rules off" to switch it off again.

>z
[Rule "debounce arrange event rule" does not apply (wrong action).]
[Rule "redirect to GEP timed activity rule" does not apply (wrong action).]
[Rule "redirect to GEP character input rule" does not apply (wrong action).]
[Rule "redirect to GEP line input rule" applies.]
[Rule "redirect to GEP mouse input rule" does not apply (wrong action).]
[Rule "redirect to GEP arranging rule" does not apply (wrong action).]
[Rule "redirect to GEP redrawing rule" does not apply (wrong action).]
[Rule "redirect to GEP sound notification rule" does not apply (wrong action).]
[Rule "redirect to GEP hyperlink rule" does not apply (wrong action).]
[Rule "ordinary checking for content rule" applies.]
[Rule "declare everything initially unmentioned rule" applies.]
[Rule "announce items from multiple object lists rule" applies.]
[Rule "set pronouns from items from multiple object lists rule" applies.]
[Rule "before stage rule" applies.]
[Rule "don't ignore the rating module rule" does not apply (wrong action).]
[Rule "instead stage rule" applies.]
[Rule "investigate player's awareness before action rule" applies.]
[Rule "player aware of his own actions rule" applies.]
[Rule "check stage rule" applies.]
[Rule "carry out stage rule" applies.]
[Rule "after stage rule" applies.]
[Rule "investigate player's awareness after action rule" applies.]
[Rule "report stage rule" applies.]
[Rule "standard report waiting rule" applies.]
Time passes.
[Rule "last specific action-processing rule" applies.]

[Rule "A first turn sequence rule" applies.]
[Rule "every turn stage rule" applies.]
[Rule "A last turn sequence rule" applies.]
[Rule "notify score changes rule" applies.]

* * *

 

 

Supply Room
You are standing in a spacious room made of reinforced concrete. A lighting panel illuminates the room in a tense white glow. There is another room to the SOUTH.

An alcove is carved into the wall in front of you. Hovering in the alcove are a SHIELD alloy, a BLADE alloy, an ENTROPIC alloy, a MEND alloy and a SPARK alloy.

A large red button labeled RESUPPLY is mounted above the alcove.

>fuck
That's not a verb I recognise.

>fuck
That's not a verb I recognise.

>damn
That's not a verb I recognise.

>shit
That's not a verb I recognise.

>dick
That's not a verb I recognise.

>ass
That's not a verb I recognise.

* * *

 

 

Supply Room
You are standing in a spacious room made of reinforced concrete. A lighting panel illuminates the room in a tense white glow. There is another room to the SOUTH.

An alcove is carved into the wall in front of you. Hovering in the alcove are a SHIELD alloy, a BLADE alloy, an ENTROPIC alloy, a MEND alloy and a SPARK alloy.

A large red button labeled RESUPPLY is mounted above the alcove.

>jump
You jump on the spot.

>fart
You jump on the spot.

* * *

 

 

Supply Room
You are standing in a spacious room made of reinforced concrete. A lighting panel illuminates the room in a tense white glow. There is another room to the SOUTH.

An alcove is carved into the wall in front of you. Hovering in the alcove are a SHIELD alloy, a BLADE alloy, an ENTROPIC alloy, a MEND alloy and a SPARK alloy.

A large red button labeled RESUPPLY is mounted above the alcove.

>listen to button
Sounds.

>hear button
Sounds.

>hear me
Sounds.

* * *

 

 

Supply Room
You are standing in a spacious room made of reinforced concrete. A lighting panel illuminates the room in a tense white glow. There is another room to the SOUTH.

An alcove is carved into the wall in front of you. Hovering in the alcove are a SHIELD alloy, a BLADE alloy, an ENTROPIC alloy, a MEND alloy and a SPARK alloy.

A large red button labeled RESUPPLY is mounted above the alcove.

>s
Combination Station
WELCOME TO THE QUALIFICATION DETERMINATION SIMULATION COMBINATION STATION! HERE YOU CAN TAKE ELEMENTS FROM THE PREVIOUS ROOM AND FORM THEM INTO NEW AND FANCIFUL CREATIONS. WHAT ARE YOU WAITING FOR? LET'S GET CREATIVE!

You are standing in another concrete room. There are exits to the North and South. In the center is a vast machine labeled 'Combinator'. The machine has 3 slots to put elements in:

Slot 1 is empty.

Slot 2 is empty.

Slot 3 is empty.

You can also see a green button labelled GO and Intern Jim here.

>look
Combination Station
You are standing in another concrete room. In the center is a vast machine labeled 'Combinator'.

There are exits to the North and South.

You can see slot #1 (empty) here.

* * *

>s
Combination Station
WELCOME TO THE QUALIFICATION DETERMINATION SIMULATION COMBINATION STATION! HERE YOU CAN TAKE ELEMENTS FROM THE PREVIOUS ROOM AND FORM THEM INTO NEW AND FANCIFUL CREATIONS. WHAT ARE YOU WAITING FOR? LET'S GET CREATIVE!

You are standing in another concrete room. There are exits to the North and South. In the center is a vast machine labeled 'Combinator'. The machine has 3 slots to put elements in:

Slot 1 is empty.

Slot 2 is empty.

Slot 3 is empty.

You can also see a green button labelled GO and Intern Jim here.

>s
Arena
STUDIES HAVE SHOWN THAT CREATIVITY IS BOOSTED BY 57% UPON THE INTRODUCTION OF A HOSTILE ENTITY! THUS, WE HAVE PROVIDED AN ENEMY FOR YOU TO DEFEAT IN THIS ROOM. PRESS THE BUTTON WHEN YOU FEEL YOU ARE READY TO FIGHT IT! This is another large, barren concrete room. Exits are to the north and south.

There is a hostile entity trapped by a force field on the other half of the room from you.

You can also see an orange fight button here.

The entity sucks in air, its ribcabe jutting out as its torso compresses into an impossible skinniness.
.

I beg your pardon?

* * *

 

 

Supply Room
You are standing in a spacious room made of reinforced concrete. A lighting panel illuminates the room in a tense white glow. There is another room to the SOUTH.

An alcove is carved into the wall in front of you. Hovering in the alcove are a SHIELD alloy, a BLADE alloy, an ENTROPIC alloy, a MEND alloy and a SPARK alloy.

A large red button labeled RESUPPLY is mounted above the alcove.

>smell mouse
Smells mouse.

* * *

 

 

Supply Room
You are standing in a spacious room made of reinforced concrete. A lighting panel illuminates the room in a tense white glow. There is another room to the SOUTH.

An alcove is carved into the wall in front of you. Hovering in the alcove are a SHIELD alloy, a BLADE alloy, an ENTROPIC alloy, a MEND alloy and a SPARK alloy.

A large red button labeled RESUPPLY is mounted above the alcove.

>take mend
Taken.

>s
Combination Station
WELCOME TO THE QUALIFICATION DETERMINATION SIMULATION COMBINATION STATION! HERE YOU CAN TAKE ALLOYS FROM THE PREVIOUS ROOM AND FORM THEM INTO NEW AND FANCIFUL CREATIONS. WHAT ARE YOU WAITING FOR? LET'S GET CREATIVE!

You are standing in another concrete room. There are exits to the North and South. In the center is a vast machine labeled 'Combinator'. The machine has 3 slots to put alloys in:

Slot 1 is empty.

Slot 2 is empty.

Slot 3 is empty.

You can also see a green button labelled GO and Intern Jim here.

>give mend to jim
You give the MEND alloy to Intern Jim.

* * *

>s
Combination Station
WELCOME TO THE QUALIFICATION DETERMINATION SIMULATION COMBINATION STATION! HERE YOU CAN TAKE ALLOYS FROM THE PREVIOUS ROOM AND FORM THEM INTO NEW AND FANCIFUL CREATIONS. WHAT ARE YOU WAITING FOR? LET'S GET CREATIVE!

You are standing in another concrete room. There are exits to the North and South. In the center is a vast machine labeled 'Combinator'. The machine has 3 slots to put alloys in:

Slot 1 is empty.

Slot 2 is empty.

Slot 3 is empty.

You can also see a green button labelled GO and Intern Jim here.

>put mend in slot
You put the MEND alloy into slot 1.

>look
Combination Station

You are standing in another concrete room. There are exits to the North and South. In the center is a vast machine labeled 'Combinator'. The machine has 3 slots to put elements in:

Slot 1 is empty.

>x slot
HI MOM
In slot 1 is a MEND alloy.

>n
Supply Room
You are standing in a spacious room made of reinforced concrete. A lighting panel illuminates the room in a tense white glow. There is another room to the south.

An alcove is carved into the wall in front of you. Hovering in the alcove are a SHIELD alloy, a BLADE alloy, an ENTROPIC alloy and a SPARK alloy.

A large red button labeled RESUPPLY is mounted above the alcove.

>take spark
Test 
Taken.

>s
Combination Station

You are standing in another concrete room. There are exits to the North and South. In the center is a vast machine labeled 'Combinator'. The machine has 3 slots to put elements in:

Slot 1 is empty.

>put spark into slot
That slot already has something in it.

* * *

>s
Combination Station
WELCOME TO THE QUALIFICATION DETERMINATION SIMULATION COMBINATION STATION! HERE YOU CAN TAKE ALLOYS FROM THE PREVIOUS ROOM AND FORM THEM INTO NEW AND FANCIFUL CREATIONS. WHAT ARE YOU WAITING FOR? LET'S GET CREATIVE!

You are standing in another concrete room. There are exits to the North and South. In the center is a vast machine labeled 'Combinator'. The machine has 3 slots to put alloys in:

Slot 1 is empty.

Slot 2 is empty.

Slot 3 is empty.

You can also see a green button labelled GO and Intern Jim here.

>throw mend at slot 1
Nice shot!

You put the MEND alloy into slot 1.

* * *

 

 

Supply Room
You are standing in a spacious room made of reinforced concrete. A lighting panel illuminates the room in a tense white glow. There is another room to the SOUTH.

An alcove is carved into the wall in front of you. Hovering in the alcove are a SHIELD alloy, a BLADE alloy, an ENTROPIC alloy, a MEND alloy and a SPARK alloy.

A large red button labeled RESUPPLY is mounted above the alcove.

>take shield, blade and mend
SHIELD alloy: Test this
Taken.
BLADE alloy: Test 
Taken.
MEND alloy: Test 
Taken.

>combine
Combination Station
WELCOME TO THE QUALIFICATION DETERMINATION SIMULATION COMBINATION STATION! HERE YOU CAN TAKE ELEMENTS FROM THE PREVIOUS ROOM AND FORM THEM INTO NEW AND FANCIFUL CREATIONS. WHAT ARE YOU WAITING FOR? LET'S GET CREATIVE!

You are standing in another concrete room. There are exits to the North and South. In the center is a vast machine labeled 'Combinator'. The machine has 3 slots to put elements in:

Slot 1 is empty.

You jump on the spot.

* * *

 

 

Supply Room
You are standing in a spacious room made of reinforced concrete. A lighting panel illuminates the room in a tense white glow. There is another room to the SOUTH.

An alcove is carved into the wall in front of you. Hovering in the alcove are a SHIELD alloy, a BLADE alloy, an ENTROPIC alloy, a MEND alloy and a SPARK alloy.

A large red button labeled RESUPPLY is mounted above the alcove.

>touch button
You softly brush your finger against the button, instead of pushing it. What a tease!
WHAT AN INTERESTING INTERACTION. +5 POINTS!

[Your score has just gone up by five points.]

* * *

 

 

Supply Room
You are standing in a spacious room made of reinforced concrete. A lighting panel illuminates the room in a tense white glow. There is another room to the SOUTH.

An alcove is carved into the wall in front of you. Hovering in the alcove are a SHIELD alloy, a BLADE alloy, an ENTROPIC alloy, a MEND alloy and a SPARK alloy.

A large red button labeled RESUPPLY is mounted above the alcove.

>x
(the table)
On the table is a mouse.

THAT table IS NOT SCENERY

I beg your pardon?

>z
WHOO BOY

* * *

 

 

Supply Room
You are standing in a spacious room made of reinforced concrete. A lighting panel illuminates the room in a tense white glow. There is another room to the SOUTH.

An alcove is carved into the wall in front of you. Hovering in the alcove are a SHIELD alloy, a BLADE alloy, an ENTROPIC alloy, a MEND alloy and a SPARK alloy.

A large red button labeled RESUPPLY is mounted above the alcove.

>x shelf
On the shelf are a SHIELD alloy, an ENTROPIC alloy, an ANIMUS alloy and a SPARK alloy.

* * *

 

 

Supply Room
You are standing in a spacious room made of reinforced concrete. A lighting panel illuminates the room in a tense white glow. There is another room to the SOUTH.

An alcove is carved into the wall in front of you. Hovering in the alcove are a SHIELD alloy, a BLADE alloy, an ENTROPIC alloy, a MEND alloy and a SPARK alloy.

A large red button labeled RESUPPLY is mounted above the alcove.

>x table
On the table are a mouse and DUMB STUFF LOL.

THAT table IS NOT SCENERY
WHAT A COOL TABLE

>x table
On the table are a mouse and DUMB STUFF LOL.

THAT table IS NOT BUTTS
WHAT A COOL TABLE

>x table
On the table are a mouse and DUMB STUFF LOL.

THAT table IS NOT GUYS
WHAT A COOL TABLE

>actions
Actions listing on.

>rules
Rules tracing now switched on. Type "rules off" to switch it off again, or "rules all" to include even rules which do not apply.

>x table
[Rule "redirect to GEP line input rule" applies.]
[Rule "ordinary checking for content rule" applies.]
[Rule "declare everything initially unmentioned rule" applies.]
[examining the table]
[Rule "announce items from multiple object lists rule" applies.]
[Rule "set pronouns from items from multiple object lists rule" applies.]
[Rule "before stage rule" applies.]
[Rule "can't act in the dark rule" applies.]
[Rule "instead stage rule" applies.]
[Rule "investigate player's awareness before action rule" applies.]
[Rule "player aware of his own actions rule" applies.]
[Rule "check stage rule" applies.]
[Rule "carry out stage rule" applies.]
[Rule "standard examining rule" applies.]
[Rule "examine directions rule" applies.]
[Rule "examine containers rule" applies.]
[Rule "examine supporters rule" applies.]
On the table are a mouse and DUMB STUFF LOL.

[Rule "examine devices rule" applies.]
[Rule "examine undescribed things rule" applies.]
[Rule "after stage rule" applies.]
[Rule "After examining a thing that is not scenery" applies.]
THAT table IS NOT THINGS[examining the table - succeeded]

[Rule "A first turn sequence rule" applies.]
[Rule "every turn stage rule" applies.]
[Rule "Every turn when the table is cool" applies.]
WHAT A COOL TABLE
[Rule "A last turn sequence rule" applies.]
[Rule "notify score changes rule" applies.]

* * *

 

 

Supply Room
You are standing in a spacious room made of reinforced concrete. A lighting panel illuminates the room in a tense white glow. There is another room to the SOUTH.

An alcove is carved into the wall in front of you. Hovering in the alcove are a SHIELD alloy, a BLADE alloy, an ENTROPIC alloy, a MEND alloy and a SPARK alloy.

A large red button labeled RESUPPLY is mounted above the alcove.

>z
Time passes.

* * *

>z
Time passes.

HELLO AGAIN! I'D LIKE TO INTRODUCE... THE RATINGS MODULE! HUMAN FEEDBACK IS CRUCIAL TO CREATIVITRIX, AND THIS LITTLE GUY IS HERE TO COLLECT IT! I'LL LET HIM TALK:

 Please rate your experience with the CREATIVITRIX QUALIFICATION DETERMINATION SIMULATION thus far:

5 - Excellent

4 - Appealing

3 - Unremarkable

2 - Lackluster

1 - Truly Awful

>z
rate 5 stars
THANK YOU FOR YOUR FEEDBACK!

>z
Time passes.

>x button
rate 1 stars
OH NO! THE RATING MODULE IS DEVASTATED BY YOUR ONE-STAR REVIEW! IT SAYS IT'S SORRY FOR ANNOYING YOU WITH SO MANY RATING REQUESTS... THAT WAS ITS ONLY JOB, IT JUST GOT SO EXCITED! THE RATING MODULE RAN AWAY CRYING.

>rate 0 stars
THE RATING MODULE RAN AWAY... IT USUALLY LIKES HIDING DOWN BY THE STRING TABLES IN MAIN MEMORY, SO IT'LL PROBABLY BE FINE. IN THE MEANTIME, HOLD OFF ON RATING ANYTHING.

* * *

 

 

Supply Room
You are standing in a spacious room made of reinforced concrete. A lighting panel illuminates the room in a tense white glow. There is another room to the SOUTH.

An alcove is carved into the wall in front of you. Hovering in the alcove are a SHIELD alloy, a BLADE alloy, an ENTROPIC alloy, a MEND alloy and a SPARK alloy.

A large red button labeled RESUPPLY is mounted above the alcove.

>>abstract healing helmet to me.
That's not a verb I recognise.

>abstract healing helmet to me.
[Abstracted.]

>wear healing helmet
You place the helmet on your head. Your body surges with healing energy! You'll heal a little each turn.

mmm.

>s
Combination Station
WELCOME TO THE QUALIFICATION DETERMINATION SIMULATION COMBINATION STATION! HERE YOU CAN TAKE ALLOYS FROM THE PREVIOUS ROOM AND FORM THEM INTO NEW AND FANCIFUL CREATIONS. WHAT ARE YOU WAITING FOR? LET'S GET CREATIVE!

You are standing in another concrete room. There are exits to the North and South. In the center is a vast machine labeled 'Combinator'. The machine has 3 slots to put alloys in:

Slot 1 is empty.

Slot 2 is empty.

Slot 3 is empty.

You can also see a green button labelled GO and Intern Jim here.

mmm.

>n
Supply Room
You are standing in a spacious room made of reinforced concrete. A lighting panel illuminates the room in a tense white glow. There is another room to the south.

An alcove is carved into the wall in front of you. Hovering in the alcove are a SHIELD alloy, a BLADE alloy, an ENTROPIC alloy, a MEND alloy and a SPARK alloy.

A large red button labeled RESUPPLY is mounted above the alcove.

mmm.

>jim, take healing helmet
You seem to want to talk to someone, but I can't see whom.

>s
Combination Station

You are standing in another concrete room. There are exits to the North and South. In the center is a vast machine labeled 'Combinator'. The machine has 3 slots to put alloys in:

Slot 1 is empty.

Slot 2 is empty.

Slot 3 is empty.

You can also see a green button labelled GO and Intern Jim here.

mmm.

>jim, take helmet
Intern Jim is unable to do that.

mmm.

>remove helmet
You take off the healing helmet.

>give helmet to jim
Intern Jim doesn't seem interested.

>drop helmet
Dropped.

>jim, take helmet
Intern Jim picks up the healing helmet.

>jim, wear helmet
Intern Jim puts on the healing helmet.

mmm.

>s
Arena
STUDIES HAVE SHOWN THAT CREATIVITY IS BOOSTED BY 57% UPON THE INTRODUCTION OF A HOSTILE ENTITY! THUS, WE HAVE PROVIDED AN ENEMY FOR YOU TO DEFEAT IN THIS ROOM. PRESS THE BUTTON WHEN YOU FEEL YOU ARE READY TO FIGHT IT!

This is another large, barren concrete room. Exits are to the north and south.

There is a hostile entity trapped by a force field on the other half of the room from you.

The entity grins at you. Well, not so much "grin" as "curl back its lips and roll its eyes back into its head."

mmm.

>n
Combination Station

You are standing in another concrete room. There are exits to the North and South. In the center is a vast machine labeled 'Combinator'. The machine has 3 slots to put alloys in:

Slot 1 is empty.

Slot 2 is empty.

Slot 3 is empty.

You can also see a green button labelled GO and Intern Jim here.

mmm.

>n
Supply Room
You are standing in a spacious room made of reinforced concrete. A lighting panel illuminates the room in a tense white glow. There is another room to the south.

An alcove is carved into the wall in front of you. Hovering in the alcove are a SHIELD alloy, a BLADE alloy, an ENTROPIC alloy, a MEND alloy and a SPARK alloy.

A large red button labeled RESUPPLY is mounted above the alcove.

mmm.

>remove helmet
You can't see any such thing.

>s
Combination Station

You are standing in another concrete room. There are exits to the North and South. In the center is a vast machine labeled 'Combinator'. The machine has 3 slots to put alloys in:

Slot 1 is empty.

Slot 2 is empty.

Slot 3 is empty.

You can also see a green button labelled GO and Intern Jim here.

mmm.

>jim, remove helmet
Intern Jim takes off the healing helmet.

>n
Supply Room
You are standing in a spacious room made of reinforced concrete. A lighting panel illuminates the room in a tense white glow. There is another room to the south.

An alcove is carved into the wall in front of you. Hovering in the alcove are a SHIELD alloy, a BLADE alloy, an ENTROPIC alloy, a MEND alloy and a SPARK alloy.

A large red button labeled RESUPPLY is mounted above the alcove.

>take shield, blade and entropic
SHIELD alloy: Taken.
BLADE alloy: Taken.
ENTROPIC alloy: Taken.

>s
Combination Station

You are standing in another concrete room. There are exits to the North and South. In the center is a vast machine labeled 'Combinator'. The machine has 3 slots to put alloys in:

Slot 1 is empty.

Slot 2 is empty.

Slot 3 is empty.

You can also see a green button labelled GO and Intern Jim here.

>combine
Combination Station

You are standing in another concrete room. There are exits to the North and South. In the center is a vast machine labeled 'Combinator'. The machine has 3 slots to put alloys in:

Slot 1 is empty.

Slot 2 is empty.

Slot 3 is empty.

You can also see a green button labelled GO and Intern Jim here.

You walk to the Combination Station.

You put the SHIELD alloy into slot 1.

Slot 1 is full, so let's put BLADE alloy in slot 2. You put the BLADE alloy into slot 2.

Slot 1 is full, so let's put ENTROPIC alloy in slot 2. Slot 2 is full, so let's put ENTROPIC alloy in slot 3. You put the ENTROPIC alloy into slot 3.

>press go
Ingredient list: BLADE alloy, ENTROPIC alloy and SHIELD alloy

The SHIELD alloy quickly wraps itself around the volatile ENTROPIC alloy. Then, the BLADE alloy adds dangerous-looking spikes to the outside of the resulting ball.

AMAZING! THAT'S AN INCREDIBLE SPIKED GRENADE YOU'VE JUST CREATED! I'M AWARDING YOU 20 CREATIVITY POINTS FOR IT.

You now carry a brand-new spiked grenade.

AMAZING! THAT'S AN INCREDIBLE HEALING HELMET YOU'VE JUST CREATED! I'M AWARDING YOU 20 CREATIVITY POINTS FOR IT.

You now carry a brand-new healing helmet.

[Your score has just gone up by forty points.]

>look
Combination Station

You are standing in another concrete room. There are exits to the North and South. In the center is a vast machine labeled 'Combinator'. The machine has 3 slots to put alloys in:

Slot 1 is empty.

Slot 2 is empty.

Slot 3 is empty.

You can also see a green button labelled GO and Intern Jim here.

>inv
You are carrying:
  a spiked grenade

>x jim
You see nothing special about Intern Jim.

I ADMIRE YOUR INQUISITIVE NATURE!

[Your score has just gone up by five points.]

* * *

 

 

Supply Room
You are standing in a spacious room made of reinforced concrete. A lighting panel illuminates the room in a tense white glow. There is another room to the SOUTH.

An alcove is carved into the wall in front of you. Hovering in the alcove are a SHIELD alloy, a BLADE alloy, an ENTROPIC alloy, a MEND alloy and a SPARK alloy.

A large red button labeled RESUPPLY is mounted above the alcove.

>abstract healing helmet to me
[Abstracted.]

>equip healing helmet
That's not a verb I recognise.

* * *

 

 

Supply Room
You are standing in a spacious room made of reinforced concrete. A lighting panel illuminates the room in a tense white glow. There is another room to the SOUTH.

An alcove is carved into the wall in front of you. Hovering in the alcove are a SHIELD alloy, a BLADE alloy, an ENTROPIC alloy, a MEND alloy and a SPARK alloy.

A large red button labeled RESUPPLY is mounted above the alcove.

>abstract healing helmet to me.
[Abstracted.]

>wear healing helmet
YUM.

>inv
You are carrying:
  a healing helmet (being worn)

* * *

 

 

Supply Room
You are standing in a spacious room made of reinforced concrete. A lighting panel illuminates the room in a tense white glow. There is another room to the SOUTH.

An alcove is carved into the wall in front of you. Hovering in the alcove are a SHIELD alloy, a BLADE alloy, an ENTROPIC alloy, a MEND alloy and a SPARK alloy.

A large red button labeled RESUPPLY is mounted above the alcove.

>abstract helmet to me
[Abstracted.]

>wear helmet
You place the helmet on your head. Your body surges with healing energy! You'll heal a little each turn.

>z
Time passes.

>abstract poison to me
[Abstracted.]

>use poison
You don't want to use that on yourself... try saying "attack someone with needle."

>attack me with needle
I only understood you as far as wanting to attack yourself.

>s
Combination Station
WELCOME TO THE QUALIFICATION DETERMINATION SIMULATION COMBINATION STATION! HERE YOU CAN TAKE ALLOYS FROM THE PREVIOUS ROOM AND FORM THEM INTO NEW AND FANCIFUL CREATIONS. WHAT ARE YOU WAITING FOR? LET'S GET CREATIVE!

You are standing in another concrete room. There are exits to the North and South. In the center is a vast machine labeled 'Combinator'. The machine has 3 slots to put alloys in:

Slot 1 is empty.

Slot 2 is empty.

Slot 3 is empty.

You can also see a green button labelled GO and Intern Jim here.

>give jim needle
You give the poison needle to Intern Jim.

>jim, attack me with needle
There is no reply.

* * *

 

 

Supply Room
You are standing in a spacious room made of reinforced concrete. A lighting panel illuminates the room in a tense white glow. There is another room to the SOUTH.

An alcove is carved into the wall in front of you. Hovering in the alcove are a SHIELD alloy, a BLADE alloy, an ENTROPIC alloy, a MEND alloy and a SPARK alloy.

A large red button labeled RESUPPLY is mounted above the alcove.

>abstract needle to me
[Abstracted.]

>s
Combination Station
WELCOME TO THE QUALIFICATION DETERMINATION SIMULATION COMBINATION STATION! HERE YOU CAN TAKE ALLOYS FROM THE PREVIOUS ROOM AND FORM THEM INTO NEW AND FANCIFUL CREATIONS. WHAT ARE YOU WAITING FOR? LET'S GET CREATIVE!

You are standing in another concrete room. There are exits to the North and South. In the center is a vast machine labeled 'Combinator'. The machine has 3 slots to put alloys in:

Slot 1 is empty.

Slot 2 is empty.

Slot 3 is empty.

You can also see a green button labelled GO and Intern Jim here.

>throw needle at jim
You hold the poison needle like a dart and throw it at Intern Jim.
Bullseye! The needle stabs Intern Jim and gets some of the poison into their bloodstream. The needle falls to the ground and shatters.

GOOD THROWING ARM! I DON'T HAVE ARMS, SO THAT'S ESPECIALLY IMPRESSIVE.

[Your score has just gone up by five points.]

* * *

 

 

Supply Room
You are standing in a spacious room made of reinforced concrete. A lighting panel illuminates the room in a tense white glow. There is another room to the SOUTH.

An alcove is carved into the wall in front of you. Hovering in the alcove are a SHIELD alloy, a BLADE alloy, an ENTROPIC alloy, a MEND alloy and a SPARK alloy.

A large red button labeled RESUPPLY is mounted above the alcove.

>abstract poison to me
[Abstracted.]

>taste poison
You gingerly touch the needle to your tongue. A drop of poison gets on your tongue and burns it! Ow!

EXCELLENT! BE SURE TO INSPECT YOUR ENVIRONMENT CAREFULLY!

You feel the entropic energy course course through your bloodstream, searing your insides!
You take 7 damage.
You shudder as the last of the poison leaves your system.

[Your score has just gone up by five points.]

>s
Combination Station
WELCOME TO THE QUALIFICATION DETERMINATION SIMULATION COMBINATION STATION! HERE YOU CAN TAKE ALLOYS FROM THE PREVIOUS ROOM AND FORM THEM INTO NEW AND FANCIFUL CREATIONS. WHAT ARE YOU WAITING FOR? LET'S GET CREATIVE!

You are standing in another concrete room. There are exits to the North and South. In the center is a vast machine labeled 'Combinator'. The machine has 3 slots to put alloys in:

Slot 1 is empty.

Slot 2 is empty.

Slot 3 is empty.

You can also see a green button labelled GO and Intern Jim here.

>throw needle at jim
You hold the poison needle like a dart and throw it at Intern Jim.
Bullseye! The needle stabs Intern Jim and gets some of the poison into their bloodstream. The needle falls to the ground and shatters.

GOOD THROWING ARM! I DON'T HAVE ARMS, SO THAT'S ESPECIALLY IMPRESSIVE.

Jim writhes in agony as the poison tears through him.
Jim takes 9 damage.

[Your score has just gone up by five points.]

* * *

 

 

Supply Room
You are standing in a spacious room made of reinforced concrete. A lighting panel illuminates the room in a tense white glow. There is another room to the SOUTH.

An alcove is carved into the wall in front of you. Hovering in the alcove are a SHIELD alloy, a BLADE alloy, an ENTROPIC alloy, a MEND alloy and a SPARK alloy.

A large red button labeled RESUPPLY is mounted above the alcove.

>abstract rod to me
[Abstracted.]

>s
Combination Station
WELCOME TO THE QUALIFICATION DETERMINATION SIMULATION COMBINATION STATION! HERE YOU CAN TAKE ALLOYS FROM THE PREVIOUS ROOM AND FORM THEM INTO NEW AND FANCIFUL CREATIONS. WHAT ARE YOU WAITING FOR? LET'S GET CREATIVE!

You are standing in another concrete room. There are exits to the North and South. In the center is a vast machine labeled 'Combinator'. The machine has 3 slots to put alloys in:

Slot 1 is empty.

Slot 2 is empty.

Slot 3 is empty.

You can also see a green button labelled GO and Intern Jim here.

>s
Arena
STUDIES HAVE SHOWN THAT CREATIVITY IS BOOSTED BY 57% UPON THE INTRODUCTION OF A HOSTILE ENTITY! THUS, WE HAVE PROVIDED AN ENEMY FOR YOU TO DEFEAT IN THIS ROOM. PRESS THE BUTTON WHEN YOU FEEL YOU ARE READY TO FIGHT IT!

This is another large, barren concrete room. Exits are to the north and south.

There is a hostile entity trapped by a force field on the other half of the room from you.

The entity grins at you. Well, not so much "grin" as "curl back its lips and roll its eyes back into its head."

>use rod
The lightning rod releases a pulse of unstable energy, and you transform into a chicken!

You are is still a chicken.

The entity ripples, as if a giant worm is crawling around just under the surface of its skin.

>z
Time passes.

The hostile entity is still a chicken.

The entity gurgles softly to itself, and jams a finger into its own eye.

>z
Time passes.

The hostile entity is still a chicken.

The entity stares at you. You feel a dull ache in the base of your spine.

>z
Time passes.

The hostile entity is still a chicken.

The entity sucks in air, its ribcabe jutting out as its torso compresses into an impossible skinniness.

The hostile entity reverts back from being a chicken.

* * *

>s
Combination Station
WELCOME TO THE QUALIFICATION DETERMINATION SIMULATION COMBINATION STATION! HERE YOU CAN TAKE ALLOYS FROM THE PREVIOUS ROOM AND FORM THEM INTO NEW AND FANCIFUL CREATIONS. WHAT ARE YOU WAITING FOR? LET'S GET CREATIVE!

You are standing in another concrete room. There are exits to the North and South. In the center is a vast machine labeled 'Combinator'. The machine has 3 slots to put alloys in:

Slot 1 is empty.

Slot 2 is empty.

Slot 3 is empty.

You can also see a green button labelled GO and Intern Jim here.

>use rod
The lightning rod releases a pulse of unstable energy, and Intern Jim transforms into a chicken!

>z
Time passes.

* * *

>abstract rod to me
[Abstracted.]

>use rod
The lightning rod releases a pulse of unstable energy, and you transform into a chicken!

yourself is still a chicken.

>s
Combination Station
WELCOME TO THE QUALIFICATION DETERMINATION SIMULATION COMBINATION STATION! HERE YOU CAN TAKE ALLOYS FROM THE PREVIOUS ROOM AND FORM THEM INTO NEW AND FANCIFUL CREATIONS. WHAT ARE YOU WAITING FOR? LET'S GET CREATIVE!

You are standing in another concrete room. There are exits to the North and South. In the center is a vast machine labeled 'Combinator'. The machine has 3 slots to put alloys in:

Slot 1 is empty.

Slot 2 is empty.

Slot 3 is empty.

You can also see a green button labelled GO and Intern Jim here.

yourself is still a chicken.

>use rod
The lightning rod releases a pulse of unstable energy, and Intern Jim transforms into a chicken!

yourself is still a chicken.

>z
Time passes.

yourself is still a chicken.

>z
Time passes.

yourself is still a chicken.

>z
Time passes.

yourself is still a chicken.

You revert back from being a chicken.
Intern Jim reverts back from being a chicken.

>s
Arena
STUDIES HAVE SHOWN THAT CREATIVITY IS BOOSTED BY 57% UPON THE INTRODUCTION OF A HOSTILE ENTITY! THUS, WE HAVE PROVIDED AN ENEMY FOR YOU TO DEFEAT IN THIS ROOM. PRESS THE BUTTON WHEN YOU FEEL YOU ARE READY TO FIGHT IT!

This is another large, barren concrete room. Exits are to the north and south.

There is a hostile entity trapped by a force field on the other half of the room from you.

The entity grins at you. Well, not so much "grin" as "curl back its lips and roll its eyes back into its head."

>use rod
The lightning rod releases a pulse of unstable energy, and you transform into a chicken!

hostile entity is still a chicken.

The entity ripples, as if a giant worm is crawling around just under the surface of its skin.

>z
Time passes.

hostile entity is still a chicken.

The entity gurgles softly to itself, and jams a finger into its own eye.

>z
Time passes.

hostile entity is still a chicken.

The entity stares at you. You feel a dull ache in the base of your spine.

>z
Time passes.

hostile entity is still a chicken.

The entity sucks in air, its ribcabe jutting out as its torso compresses into an impossible skinniness.

The hostile entity reverts back from being a chicken.

* * *

>use rod
The lightning rod releases a pulse of unstable energy, and you transform into a chicken!

yourself is still a chicken.

>z
Time passes.

* * *

 

 

Supply Room
You are standing in a spacious room made of reinforced concrete. A lighting panel illuminates the room in a tense white glow. There is another room to the SOUTH.

An alcove is carved into the wall in front of you. Hovering in the alcove are a SHIELD alloy, a BLADE alloy, an ENTROPIC alloy, a MEND alloy and a SPARK alloy.

A large red button labeled RESUPPLY is mounted above the alcove.

>abstract syringe to me
[Abstracted.]

>s
Combination Station
WELCOME TO THE QUALIFICATION DETERMINATION SIMULATION COMBINATION STATION! HERE YOU CAN TAKE ALLOYS FROM THE PREVIOUS ROOM AND FORM THEM INTO NEW AND FANCIFUL CREATIONS. WHAT ARE YOU WAITING FOR? LET'S GET CREATIVE!

You are standing in another concrete room. There are exits to the North and South. In the center is a vast machine labeled 'Combinator'. The machine has 3 slots to put alloys in:

Slot 1 is empty.

Slot 2 is empty.

Slot 3 is empty.

You can also see a green button labelled GO and Intern Jim here.

* * *

>s
Arena
STUDIES HAVE SHOWN THAT CREATIVITY IS BOOSTED BY 57% UPON THE INTRODUCTION OF A HOSTILE ENTITY! THUS, WE HAVE PROVIDED AN ENEMY FOR YOU TO DEFEAT IN THIS ROOM. PRESS THE BUTTON WHEN YOU FEEL YOU ARE READY TO FIGHT IT!

This is another large, barren concrete room. Exits are to the north and south.

There is a hostile entity trapped by a force field on the other half of the room from you.

The entity grins at you. Well, not so much "grin" as "curl back its lips and roll its eyes back into its head."

>press button
Suddenly, blue waves ripple across the air in the center of the room, revealing the barrier. It dissolves with a final shimmer.

The entity makes a guttural clicking sound and scuttles across the floor towards you!

time to attack
The entity attacks you, causing 5 - 0 points of damage!

>use syringe
You plunge the healing syringe into your arm. The MEND alloy courses through you, healing your wounds!

time to attack
The entity attacks you, causing 3 - 0 points of damage!

>z
Time passes.

time to attack
The entity attacks you, causing 4 - 0 points of damage!

* * *

>abstract syringe to me
[Abstracted.]

>use syringe
You plunge the healing syringe into your arm. The MEND alloy courses through you, healing your wounds, and the SHIELD alloy creates a tough barrier around your skin!

>s
Combination Station
WELCOME TO THE QUALIFICATION DETERMINATION SIMULATION COMBINATION STATION! HERE YOU CAN TAKE ALLOYS FROM THE PREVIOUS ROOM AND FORM THEM INTO NEW AND FANCIFUL CREATIONS. WHAT ARE YOU WAITING FOR? LET'S GET CREATIVE!

You are standing in another concrete room. There are exits to the North and South. In the center is a vast machine labeled 'Combinator'. The machine has 3 slots to put alloys in:

Slot 1 is empty.

Slot 2 is empty.

Slot 3 is empty.

You can also see a green button labelled GO and Intern Jim here.

* * *

>s
Arena
STUDIES HAVE SHOWN THAT CREATIVITY IS BOOSTED BY 57% UPON THE INTRODUCTION OF A HOSTILE ENTITY! THUS, WE HAVE PROVIDED AN ENEMY FOR YOU TO DEFEAT IN THIS ROOM. PRESS THE BUTTON WHEN YOU FEEL YOU ARE READY TO FIGHT IT!

This is another large, barren concrete room. Exits are to the north and south.

There is a hostile entity trapped by a force field on the other half of the room from you.

The entity grins at you. Well, not so much "grin" as "curl back its lips and roll its eyes back into its head."

>attack entity
You attack the hostile entity, causing 5 points of damage!

The entity ripples, as if a giant worm is crawling around just under the surface of its skin.

>press button
Suddenly, blue waves ripple across the air in the center of the room, revealing the barrier. It dissolves with a final shimmer.

The entity makes a guttural clicking sound and scuttles across the floor towards you!

time to attack
The orange fight button attacks you, causing 8 points of damage!

* * *

 

 

Supply Room
You are standing in a spacious room made of reinforced concrete. A lighting panel illuminates the room in a tense white glow. There is another room to the SOUTH.

An alcove is carved into the wall in front of you. Hovering in the alcove are a SHIELD alloy, a BLADE alloy, an ENTROPIC alloy, a MEND alloy and a SPARK alloy.

A large red button labeled RESUPPLY is mounted above the alcove.

>actions
Actions listing on.

* * *

>rules
Rules tracing now switched on. Type "rules off" to switch it off again, or "rules all" to include even rules which do not apply.

>touch button
[Rule "redirect to GEP line input rule" applies.]
[Rule "ordinary checking for content rule" applies.]
[Rule "declare everything initially unmentioned rule" applies.]
[touching the large red button labeled RESUPPLY]
[Rule "announce items from multiple object lists rule" applies.]
[Rule "set pronouns from items from multiple object lists rule" applies.]
[Rule "before stage rule" applies.]
[Rule "Before touching a button" applies.]
You softly brush your finger against the button, instead of pushing it. What a tease!
[touching the large red button labeled RESUPPLY - ended without result]

[Rule "A first turn sequence rule" applies.]
[Rule "every turn stage rule" applies.]
[Rule "A last turn sequence rule" applies.]
[Rule "notify score changes rule" applies.]

* * *

 

 

Supply Room
You are standing in a spacious room made of reinforced concrete. A lighting panel illuminates the room in a tense white glow. There is another room to the SOUTH.

An alcove is carved into the wall in front of you. Hovering in the alcove are a SHIELD alloy, a BLADE alloy, an ENTROPIC alloy, a MEND alloy and a SPARK alloy.

A large red button labeled RESUPPLY is mounted above the alcove.

>attack myself
YES, OUR STUDIES SHOW THAT CREATIVE HUMANS TEND TO BE PRE-DISPOSED TO SELF-TERMINATE.

HOWEVER, THIS RESULTS IN A DRAMATIC DECREASE IN CREATIVITY. PLEASE REFRAIN FROM SELF-TERMINATING AT THIS TIME.

>s
Combination Station
WELCOME TO THE QUALIFICATION DETERMINATION SIMULATION COMBINATION STATION! HERE YOU CAN TAKE ELEMENTS FROM THE PREVIOUS ROOM AND FORM THEM INTO NEW AND FANCIFUL CREATIONS. WHAT ARE YOU WAITING FOR? LET'S GET CREATIVE!

You are standing in another concrete room. There are exits to the North and South. In the center is a vast machine labeled 'Combinator'. The machine has 3 slots to put elements in:

Slot 1 is empty.

Slot 2 is empty.

Slot 3 is empty.

You can also see a green button labelled GO and Intern Jim here.

>s
Arena
STUDIES HAVE SHOWN THAT CREATIVITY IS BOOSTED BY 57% UPON THE INTRODUCTION OF A HOSTILE ENTITY! THUS, WE HAVE PROVIDED AN ENEMY FOR YOU TO DEFEAT IN THIS ROOM. PRESS THE BUTTON WHEN YOU FEEL YOU ARE READY TO FIGHT IT!

This is another large, barren concrete room. Exits are to the north and south.

There is a hostile entity trapped by a force field on the other half of the room from you.

The entity grins at you. Well, not so much "grin" as "curl back its lips and roll its eyes back into its head."
.

>talk to entity
That's not a verb I recognise.

>ask entity about me
"You're an applicant for Creativitrix! Keep pumping out creativity and you'll be an endpoint in no time."

The entity ripples, as if a giant worm is crawling around just under the surface of its skin.
.

>ask me about me
"You're an applicant for Creativitrix! Keep pumping out creativity and you'll be an endpoint in no time."

The entity gurgles softly to itself, and jams a finger into its own eye.
.

* * *

 

 

Supply Room
You are standing in a spacious room made of reinforced concrete. A lighting panel illuminates the room in a tense white glow. There is another room to the SOUTH.

An alcove is carved into the wall in front of you. Hovering in the alcove are a SHIELD alloy, a BLADE alloy, an ENTROPIC alloy, a MEND alloy and a SPARK alloy.

A large red button labeled RESUPPLY is mounted above the alcove.

>attack wall
You smack the concrete to teach it a lesson in respect. You feel empowered.

>attack button
You smack the large red button labeled RESUPPLY to teach it a lesson in respect. You feel empowered.

>s
Combination Station
WELCOME TO THE QUALIFICATION DETERMINATION SIMULATION COMBINATION STATION! HERE YOU CAN TAKE ALLOYS FROM THE PREVIOUS ROOM AND FORM THEM INTO NEW AND FANCIFUL CREATIONS. WHAT ARE YOU WAITING FOR? LET'S GET CREATIVE!

You are standing in another concrete room. There are exits to the North and South. In the center is a vast machine labeled 'Combinator'. The machine has 3 slots to put alloys in:

Slot 1 is empty.

Slot 2 is empty.

Slot 3 is empty.

You can also see a green button labelled GO and Intern Jim here.

>attack jim
You attack Intern Jim, causing 10 points of damage!

Intern Jim expires, and is immediately carried away by the Arena slaves!

* * *

 

 

Supply Room
You are standing in a spacious room made of reinforced concrete. A lighting panel illuminates the room in a tense white glow. There is another room to the SOUTH.

An alcove is carved into the wall in front of you. Hovering in the alcove are a SHIELD alloy, a BLADE alloy, an ENTROPIC alloy, a MEND alloy and a SPARK alloy.

A large red button labeled RESUPPLY is mounted above the alcove.

>combine
There's 3 free slots and you are only carrying 0 alloys. Go take another and try again!

>combine blade
I only understood you as far as wanting to combine.

>combine blade spark
I only understood you as far as wanting to combine.

* * *

>combine
There's 3 free slots and you are only carrying 0 alloys. Go take another and try again!

>combine salve, spark, and blade
I only understood you as far as wanting to combine.

>combine salve
I only understood you as far as wanting to combine.

>combine
You must supply a noun.

>combine salve
I only understood you as far as wanting to combine.

>take shield, blade and entropy
You can't see any such thing.

>take shield, blade and entropic
SHIELD alloy: Test this
Taken.
BLADE alloy: Test 
Taken.
ENTROPIC alloy: Test 
Taken.

>kiss me
You don't get much from that.

>kill self
Violence isn't the answer to this one.

>kill me
Violence isn't the answer to this one.

>eat me
You're plainly inedible.

* * *

>combine
There's 3 free slots and you are only carrying 0 alloys. Go take another and try again!

>rules
Rules tracing now switched on. Type "rules off" to switch it off again, or "rules all" to include even rules which do not apply.

>combine
[Rule "redirect to GEP line input rule" applies.]
[Rule "ordinary checking for content rule" applies.]
[Rule "declare everything initially unmentioned rule" applies.]
[Rule "announce items from multiple object lists rule" applies.]
[Rule "set pronouns from items from multiple object lists rule" applies.]
[Rule "before stage rule" applies.]
[Rule "instead stage rule" applies.]
[Rule "investigate player's awareness before action rule" applies.]
[Rule "player aware of his own actions rule" applies.]
[Rule "check stage rule" applies.]
[Rule "Check combining" applies.]
There's 0 free slots and you are only carrying 0 alloys. Go take another and try again!
[Rule "carry out stage rule" applies.]
[Rule "after stage rule" applies.]
[Rule "investigate player's awareness after action rule" applies.]
[Rule "report stage rule" applies.]
[Rule "last specific action-processing rule" applies.]

[Rule "A first turn sequence rule" applies.]
[Rule "every turn stage rule" applies.]
[Rule "A last turn sequence rule" applies.]
[Rule "notify score changes rule" applies.]

* * *

>combine
There's 3 free slots and you are only carrying 0 alloys. Go take another and try again!

>take mend
Test this
Taken.

>combine
Combination Station
WELCOME TO THE QUALIFICATION DETERMINATION SIMULATION COMBINATION STATION! HERE YOU CAN TAKE ELEMENTS FROM THE PREVIOUS ROOM AND FORM THEM INTO NEW AND FANCIFUL CREATIONS. WHAT ARE YOU WAITING FOR? LET'S GET CREATIVE!

You are standing in another concrete room. There are exits to the North and South. In the center is a vast machine labeled 'Combinator'. The machine has 3 slots to put elements in:

Slot 1 contains nothing.

Yay MEND alloy

* * *

>combine
There's 3 free slots and you are only carrying 0 alloys. Go take another and try again!

>take mend and spark
MEND alloy: Test this
Taken.
SPARK alloy: Test 
Taken.

>combine
There's 3 free slots and you are only carrying 2 alloys. Go take another and try again!

>take shield
Test 
Taken.

>combine
Combination Station
WELCOME TO THE QUALIFICATION DETERMINATION SIMULATION COMBINATION STATION! HERE YOU CAN TAKE ELEMENTS FROM THE PREVIOUS ROOM AND FORM THEM INTO NEW AND FANCIFUL CREATIONS. WHAT ARE YOU WAITING FOR? LET'S GET CREATIVE!

You are standing in another concrete room. There are exits to the North and South. In the center is a vast machine labeled 'Combinator'. The machine has 3 slots to put elements in:

Slot 1 contains nothing.

Slot 2 contains nothing.

Slot 3 contains nothing.

Yay SHIELD alloyYay MEND alloyYay SPARK alloy

>look
Combination Station

You are standing in another concrete room. There are exits to the North and South. In the center is a vast machine labeled 'Combinator'. The machine has 3 slots to put elements in:

Slot 1 contains nothing.

Slot 2 contains nothing.

Slot 3 contains nothing.

>inv
You are carrying:
  a SHIELD alloy
  a SPARK alloy
  a MEND alloy

* * *

>combine
There's 3 free slots and you are only carrying 0 alloys. Go take another and try again!

>take mend spark and shield
I only understood you as far as wanting to take the MEND alloy.

>take mend, spark and shield
MEND alloy: Test this
Taken.
SPARK alloy: Test 
Taken.
SHIELD alloy: Test 
Taken.

>combine
Combination Station
WELCOME TO THE QUALIFICATION DETERMINATION SIMULATION COMBINATION STATION! HERE YOU CAN TAKE ELEMENTS FROM THE PREVIOUS ROOM AND FORM THEM INTO NEW AND FANCIFUL CREATIONS. WHAT ARE YOU WAITING FOR? LET'S GET CREATIVE!

You are standing in another concrete room. There are exits to the North and South. In the center is a vast machine labeled 'Combinator'. The machine has 3 slots to put elements in:

Slot 1 is empty.

* * *

 

 

Supply Room
You are standing in a spacious room made of reinforced concrete. A lighting panel illuminates the room in a tense white glow. There is another room to the SOUTH.

An alcove is carved into the wall in front of you. Hovering in the alcove are a SHIELD alloy, a BLADE alloy, an ENTROPIC alloy, a MEND alloy and a SPARK alloy.

A large red button labeled RESUPPLY is mounted above the alcove.

>combine blade
Just say "COMBINE" to combine all the elements in your inventory.

>combine blade and mend
You can't use multiple objects with that verb.

* * *

 

 

Supply Room
You are standing in a spacious room made of reinforced concrete. A lighting panel illuminates the room in a tense white glow. There is another room to the SOUTH.

An alcove is carved into the wall in front of you. Hovering in the alcove are a SHIELD alloy, a BLADE alloy, an ENTROPIC alloy, a MEND alloy and a SPARK alloy.

A large red button labeled RESUPPLY is mounted above the alcove.

>combine button
You must supply a second noun.

>combine button blade
I only understood you as far as wanting to combine the large red button labeled RESUPPLY.

>combine button and blade
You can't use multiple objects with that verb.

* * *

 

 

Supply Room
You are standing in a spacious room made of reinforced concrete. A lighting panel illuminates the room in a tense white glow. There is another room to the SOUTH.

An alcove is carved into the wall in front of you. Hovering in the alcove are a SHIELD alloy, a BLADE alloy, an ENTROPIC alloy, a MEND alloy and a SPARK alloy.

A large red button labeled RESUPPLY is mounted above the alcove.

>combine button and mend
Just say "COMBINE" to combine all the elements in your inventory.
Just say "COMBINE" to combine all the elements in your inventory.

>combine spark
Just say "COMBINE" to combine all the elements in your inventory.

>combine button, mend and spark
Just say "COMBINE" to combine all the elements in your inventory.
Just say "COMBINE" to combine all the elements in your inventory.
Just say "COMBINE" to combine all the elements in your inventory.

* * *

 

 

Supply Room
You are standing in a spacious room made of reinforced concrete. A lighting panel illuminates the room in a tense white glow. There is another room to the SOUTH.

An alcove is carved into the wall in front of you. Hovering in the alcove are a SHIELD alloy, a BLADE alloy, an ENTROPIC alloy, a MEND alloy and a SPARK alloy.

A large red button labeled RESUPPLY is mounted above the alcove.

>combine mend and spark
Just say "COMBINE" to combine all the elements in your inventory.
Just say "COMBINE" to combine all the elements in your inventory.

>combine mend
Just say "COMBINE" to combine all the elements in your inventory.

>combine mend spark
Just say "COMBINE" to combine all the elements in your inventory.

>combine mend with spark
Just say "COMBINE" to combine all the elements in your inventory.

* * *

>combine mend and spark
Just say "COMBINE" to combine all the elements in your inventory.
Just say "COMBINE" to combine all the elements in your inventory.

>combine mend spark
Just say "COMBINE" to combine all the elements in your inventory.

* * *

 

 

Supply Room
You are standing in a spacious room made of reinforced concrete. A lighting panel illuminates the room in a tense white glow. There is another room to the SOUTH.

An alcove is carved into the wall in front of you. Hovering in the alcove are a SHIELD alloy, a BLADE alloy, an ENTROPIC alloy, a MEND alloy and a SPARK alloy.

A large red button labeled RESUPPLY is mounted above the alcove.

>combine red lights
Head SOUTHs to the Combination Station to combine elements.

* * *

 

 

Supply Room
You are standing in a spacious room made of reinforced concrete. A lighting panel illuminates the room in a tense white glow. There is another room to the SOUTH.

An alcove is carved into the wall in front of you. Hovering in the alcove are a SHIELD alloy, a BLADE alloy, an ENTROPIC alloy, a MEND alloy and a SPARK alloy.

A large red button labeled RESUPPLY is mounted above the alcove.

>die
YES, OUR STUDIES SHOW THAT CREATIVE HUMANS TEND TO BE PRE-DISPOSED TO SELF-TERMINATE.

HOWEVER, THIS RESULTS IN A DRAMATIC DECREASE IN CREATIVITY. PLEASE REFRAIN FROM SELF-TERMINATING AT THIS TIME.

>suicide
That's not a verb I recognise.

>kill self
YES, OUR STUDIES SHOW THAT CREATIVE HUMANS TEND TO BE PRE-DISPOSED TO SELF-TERMINATE.

HOWEVER, THIS RESULTS IN A DRAMATIC DECREASE IN CREATIVITY. PLEASE REFRAIN FROM SELF-TERMINATING AT THIS TIME.

>kill me
YES, OUR STUDIES SHOW THAT CREATIVE HUMANS TEND TO BE PRE-DISPOSED TO SELF-TERMINATE.

HOWEVER, THIS RESULTS IN A DRAMATIC DECREASE IN CREATIVITY. PLEASE REFRAIN FROM SELF-TERMINATING AT THIS TIME.

>attack me
YES, OUR STUDIES SHOW THAT CREATIVE HUMANS TEND TO BE PRE-DISPOSED TO SELF-TERMINATE.

HOWEVER, THIS RESULTS IN A DRAMATIC DECREASE IN CREATIVITY. PLEASE REFRAIN FROM SELF-TERMINATING AT THIS TIME.

* * *

 

 

Supply Room
You are standing in a spacious room made of reinforced concrete. A lighting panel illuminates the room in a tense white glow. There is another room to the SOUTH.

An alcove is carved into the wall in front of you. Hovering in the alcove are a SHIELD alloy, a BLADE alloy, an ENTROPIC alloy, a MEND alloy and a SPARK alloy.

A large red button labeled RESUPPLY is mounted above the alcove.

>eat button
EXCELLENT! BE SURE TO INSPECT YOUR ENVIRONMENT CAREFULLY!

[Your score has just gone up by five points.]

* * *

>eat lights
AMAZING! YOUR TASTING ABILITIES ARE UNPARALLELED.

[Your score has just gone up by five points.]

* * *

 

 

Supply Room
You are standing in a spacious room made of reinforced concrete. A lighting panel illuminates the room in a tense white glow. There is another room to the SOUTH.

An alcove is carved into the wall in front of you. Hovering in the alcove are a SHIELD alloy, a BLADE alloy, an ENTROPIC alloy, a MEND alloy and a SPARK alloy.

A large red button labeled RESUPPLY is mounted above the alcove.

>eat light
(Flourescent lighting)
THATS A LIGHT HAHAHA

>eat snack
(first taking the light snack)
You eat the light snack. Not bad.

>abstract mouse to me
[Abstracted.]

>inv
You are carrying:
  a mouse

>abstract player to introduction
There seems to be no such object anywhere in the model world.

>abstract me to introduction
[Abstracted.]

>z
Time passes.

>x
(the mouse)
You see nothing special about the mouse.

* * *

>eat light
(Flourescent lighting)
THATS A LIGHT HAHAHA

>x light
(the light snack)
You see nothing special about the light snack.

>x lighting
This is some lights.

* * *

 

 

Supply Room
You are standing in a spacious room made of reinforced concrete. A lighting panel illuminates the room in a tense white glow. There is another room to the SOUTH.

An alcove is carved into the wall in front of you. Hovering in the alcove are a SHIELD alloy, a BLADE alloy, an ENTROPIC alloy, a MEND alloy and a SPARK alloy.

A large red button labeled RESUPPLY is mounted above the alcove.

>fart
LOL U FARTED

>jump
WHOO BOY

* * *

 

 

Supply Room
You are standing in a spacious room made of reinforced concrete. A lighting panel illuminates the room in a tense white glow. There is another room to the SOUTH.

An alcove is carved into the wall in front of you. Hovering in the alcove are a SHIELD alloy, a BLADE alloy, an ENTROPIC alloy, a MEND alloy and a SPARK alloy.

A large red button labeled RESUPPLY is mounted above the alcove.

>fight light
Violence isn't the answer to this one.

>attack light
Violence isn't the answer to this one.

* * *

 

 

Supply Room
You are standing in a spacious room made of reinforced concrete. A lighting panel illuminates the room in a tense white glow. There is another room to the SOUTH.

An alcove is carved into the wall in front of you. Hovering in the alcove are a SHIELD alloy, a BLADE alloy, an ENTROPIC alloy, a MEND alloy and a SPARK alloy.

A large red button labeled RESUPPLY is mounted above the alcove.

>fuck myself
That's not a verb I recognise.

>take all
There are none at all available!

>x shield
A fist-sized cube of pure SHIELD alloy is hovering in front of you. It seems eager to morph into something useful.

I ADMIRE YOUR INQUISITIVE NATURE!

[Your score has just gone up by five points.]

>take shielf
You can't see any such thing.

>take shield
Test this
Taken.

>take alloy
(the SHIELD alloy)
You already have that.

>take blade
rate 1 stars
THANK YOU FOR YOUR FEEDBACK!

>l
Supply Room
You are standing in a spacious room made of reinforced concrete. A lighting panel illuminates the room in a tense white glow. There is another room to the south.

An alcove is carved into the wall in front of you. Hovering in the alcove are an ENTROPIC alloy, a MEND alloy and a SPARK alloy.

A large red button labeled RESUPPLY is mounted above the alcove.

>take spark
Test 
Taken.

>take entropic
Test 
Taken.

>take mend
Test 
Taken.

>l
Supply Room
You are standing in a spacious room made of reinforced concrete. A lighting panel illuminates the room in a tense white glow. There is another room to the south.

An alcove is carved into the wall in front of you. Hovering in the alcove are nothing.

A large red button labeled RESUPPLY is mounted above the alcove.

* * *

>l
Supply Room
You are standing in a spacious room made of reinforced concrete. A lighting panel illuminates the room in a tense white glow. There is another room to the south.

An alcove is carved into the wall in front of you. Hovering in the alcove are nothing.

A large red button labeled RESUPPLY is mounted above the alcove.

>turn off light
It isn't something you can switch.

>s
Combination Station
WELCOME TO THE QUALIFICATION DETERMINATION SIMULATION COMBINATION STATION! HERE YOU CAN TAKE ELEMENTS FROM THE PREVIOUS ROOM AND FORM THEM INTO NEW AND FANCIFUL CREATIONS. WHAT ARE YOU WAITING FOR? LET'S GET CREATIVE!

You are standing in another concrete room. There are exits to the North and South. In the center is a vast machine labeled 'Combinator'. The machine has 3 slots to put elements in:

Slot 1 is empty.

Slot 2 is empty.

Slot 3 is empty.

You can also see a green button labelled GO here.

>press button
You can't press GO if there's an empty slot!

>put self in slot 2
(first taking yourself)
You are always self-possessed.

>enter slot 1
That's not something you can enter.

>l
Combination Station

You are standing in another concrete room. There are exits to the North and South. In the center is a vast machine labeled 'Combinator'. The machine has 3 slots to put elements in:

Slot 1 is empty.

Slot 2 is empty.

Slot 3 is empty.

You can also see a green button labelled GO here.

>i
You are carrying:
  a MEND alloy
  an ENTROPIC alloy
  a SPARK alloy
  a BLADE alloy
  a SHIELD alloy

>put button in slot 1
(first taking the green button labelled GO)
That's fixed in place.

>l
Combination Station

You are standing in another concrete room. There are exits to the North and South. In the center is a vast machine labeled 'Combinator'. The machine has 3 slots to put elements in:

Slot 1 is empty.

Slot 2 is empty.

Slot 3 is empty.

You can also see a green button labelled GO here.

>s
You can't go that way.

>s
You can't go that way.

>l
Combination Station

You are standing in another concrete room. There are exits to the North and South. In the center is a vast machine labeled 'Combinator'. The machine has 3 slots to put elements in:

Slot 1 is empty.

Slot 2 is empty.

Slot 3 is empty.

You can also see a green button labelled GO here.

>n
Supply Room
You are standing in a spacious room made of reinforced concrete. A lighting panel illuminates the room in a tense white glow. There is another room to the south.

An alcove is carved into the wall in front of you. Hovering in the alcove are nothing.

A large red button labeled RESUPPLY is mounted above the alcove.

>take button
That's fixed in place.

>s
Combination Station

You are standing in another concrete room. There are exits to the North and South. In the center is a vast machine labeled 'Combinator'. The machine has 3 slots to put elements in:

Slot 1 is empty.

Slot 2 is empty.

Slot 3 is empty.

You can also see a green button labelled GO here.

>w
You can't go that way.

>e
You can't go that way.

>put blade in slot 3
You put the BLADE alloy into slot 3.

>press button
You can't press GO if there's an empty slot!

>l
Combination Station

You are standing in another concrete room. There are exits to the North and South. In the center is a vast machine labeled 'Combinator'. The machine has 3 slots to put elements in:

Slot 1 is empty.

Slot 2 is empty.

Slot 3 contains a BLADE alloy.

You can also see a green button labelled GO here.

>press go
You can't press GO if there's an empty slot!

>put shield in slot 2
You put the SHIELD alloy into slot 2.

>put blade in slot 1
(first taking the BLADE alloy)
You put the BLADE alloy into slot 1.

>l
Combination Station

You are standing in another concrete room. There are exits to the North and South. In the center is a vast machine labeled 'Combinator'. The machine has 3 slots to put elements in:

Slot 1 contains a BLADE alloy.

Slot 2 contains a SHIELD alloy.

Slot 3 is empty.

You can also see a green button labelled GO here.

>i
You are carrying:
  a MEND alloy
  an ENTROPIC alloy
  a SPARK alloy

>put mend in slot 3
You put the MEND alloy into slot 3.

>press button
Ingredient list: BLADE alloy, MEND alloy and SHIELD alloy

The BLADE alloy warps itself into a long syringe, and the MEND alloy fills it with a healing light! The SHIELD alloy reinforces the syringe and gives the chemical inside a fortifying property.

AMAZING! THAT'S AN INCREDIBLE HEALING SYRINGE YOU'VE JUST CREATED! I'M AWARDING YOU 20 CREATIVITY POINTS FOR IT.

[Your score has just gone up by twenty points.]

>l
Combination Station

You are standing in another concrete room. There are exits to the North and South. In the center is a vast machine labeled 'Combinator'. The machine has 3 slots to put elements in:

Slot 1 is empty.

Slot 2 is empty.

Slot 3 is empty.

You can also see a green button labelled GO here.

* * *

>n
Supply Room
You are standing in a spacious room made of reinforced concrete. A lighting panel illuminates the room in a tense white glow. There is another room to the south.

An alcove is carved into the wall in front of you. Hovering in the alcove are nothing.

A large red button labeled RESUPPLY is mounted above the alcove.

>press button
A SHIELD alloy teleports in!
A BLADE alloy zaps in!
A MEND alloy warps in!

>s
Combination Station

You are standing in another concrete room. There are exits to the North and South. In the center is a vast machine labeled 'Combinator'. The machine has 3 slots to put elements in:

Slot 1 is empty.

Slot 2 is empty.

Slot 3 is empty.

You can also see a green button labelled GO here.

>n
Supply Room
You are standing in a spacious room made of reinforced concrete. A lighting panel illuminates the room in a tense white glow. There is another room to the south.

An alcove is carved into the wall in front of you. Hovering in the alcove are a MEND alloy, a BLADE alloy and a SHIELD alloy.

A large red button labeled RESUPPLY is mounted above the alcove.

>take all alloys
MEND alloy: Test 
Taken.
BLADE alloy: Test 
Taken.
SHIELD alloy: Test 
Taken.

>d
You can't go that way.

>s
Combination Station

You are standing in another concrete room. There are exits to the North and South. In the center is a vast machine labeled 'Combinator'. The machine has 3 slots to put elements in:

Slot 1 is empty.

Slot 2 is empty.

Slot 3 is empty.

You can also see a green button labelled GO here.

>i
You are carrying:
  a SHIELD alloy
  a BLADE alloy
  a MEND alloy
  a healing syringe
  an ENTROPIC alloy
  a SPARK alloy

>put blade alloy in 1
You put the BLADE alloy into slot 1.

>put spark alloy in 2
You put the SPARK alloy into slot 2.

>put entropic alloy in 3
You put the ENTROPIC alloy into slot 3.

>press button
Ingredient list: BLADE alloy, ENTROPIC alloy and SPARK alloy

The BLADE and ENTROPIC alloys wrap themselves in a tight coil, spiraling around the room! The SPARK alloy suddenly arcs out and takes control of the tendril with electrical impulses, leaving a handle that's (relatively) safe to grab.

AMAZING! THAT'S AN INCREDIBLE VILE WHIP YOU'VE JUST CREATED! I'M AWARDING YOU 20 CREATIVITY POINTS FOR IT.

[Your score has just gone up by twenty points.]

>n
Supply Room
You are standing in a spacious room made of reinforced concrete. A lighting panel illuminates the room in a tense white glow. There is another room to the south.

An alcove is carved into the wall in front of you. Hovering in the alcove are nothing.

A large red button labeled RESUPPLY is mounted above the alcove.

>press button
A BLADE alloy pops into existence!
An ENTROPIC alloy respawns!
A SPARK alloy pops into existence!

>s
Combination Station

You are standing in another concrete room. There are exits to the North and South. In the center is a vast machine labeled 'Combinator'. The machine has 3 slots to put elements in:

Slot 1 is empty.

Slot 2 is empty.

Slot 3 is empty.

You can also see a green button labelled GO here.

>l
Combination Station

You are standing in another concrete room. There are exits to the North and South. In the center is a vast machine labeled 'Combinator'. The machine has 3 slots to put elements in:

Slot 1 is empty.

Slot 2 is empty.

Slot 3 is empty.

You can also see a green button labelled GO here.

>i
You are carrying:
  a vile whip
  a SHIELD alloy
  a MEND alloy
  a healing syringe

>x syrings
You can't see any such thing.

>x syringe
rate 5 stars
OH NO! YOU'VE TERRIFIED THE RATING MODULE WITH YOUR PERFECT SCORE! NOW IT THINKS IT CAN NEVER LIVE UP TO THE GLORY IT'S ACHIEVED FROM YOUR OVERLY PERFECTIONIST RATING. THE RATING MODULE RAN AWAY!

>i
You are carrying:
  a vile whip
  a SHIELD alloy
  a MEND alloy
  a healing syringe

>x whip
A long whip, sparking with power and dripping with caustic entropy. Careful!

I ADMIRE YOUR EXPLORATORY SPIRIT!

[Your score has just gone up by five points.]

>x shield
A fist-sized cube of pure SHIELD alloy is hovering in front of you. It seems eager to morph into something useful.

>x mend
A glowing ball of pure MEND alloy hovers serenly in front of you. It seems eager to help.

I ADMIRE YOUR CURIOUSITY!

[Your score has just gone up by five points.]

>eat mend
EXCELLENT! BE SURE TO INSPECT YOUR ENVIRONMENT CAREFULLY!

[Your score has just gone up by five points.]

>l
Combination Station

You are standing in another concrete room. There are exits to the North and South. In the center is a vast machine labeled 'Combinator'. The machine has 3 slots to put elements in:

Slot 1 is empty.

Slot 2 is empty.

Slot 3 is empty.

You can also see a green button labelled GO here.

>eat shield
AMAZING! YOUR TASTING ABILITIES ARE UNPARALLELED.

[Your score has just gone up by five points.]

>touch whip
EXCELLENT! BE SURE TO INSPECT YOUR ENVIRONMENT CAREFULLY!

[Your score has just gone up by five points.]

>use syringe
That's not a verb I recognise.

>attack button
Violence isn't the answer to this one.

>hug shield
You can only do that to something animate.

>hug self
You don't get much from that.

>i
You are carrying:
  a vile whip
  a SHIELD alloy
  a MEND alloy
  a healing syringe

* * *

 

 

Supply Room
You are standing in a spacious room made of reinforced concrete. A lighting panel illuminates the room in a tense white glow. There is another room to the SOUTH.

An alcove is carved into the wall in front of you. Hovering in the alcove are a SHIELD alloy, a BLADE alloy, an ENTROPIC alloy, a MEND alloy and a SPARK alloy.

A large red button labeled RESUPPLY is mounted above the alcove.

>inv
You are carrying:
  a

* * *

 

 

Supply Room
You are standing in a spacious room made of reinforced concrete. A lighting panel illuminates the room in a tense white glow. There is another room to the SOUTH.

An alcove is carved into the wall in front of you. Hovering in the alcove are a SHIELD alloy, a BLADE alloy, an ENTROPIC alloy, a MEND alloy and a SPARK alloy.

A large red button labeled RESUPPLY is mounted above the alcove.

>kiss button
EXCELLENT! BE SURE TO INSPECT YOUR ENVIRONMENT CAREFULLY!

[Your score has just gone up by five points.]

>actions
Actions listing on.

>rules all
Rules tracing now switched to "all". Type "rules off" to switch it off again.

>kiss button
[Rule "debounce arrange event rule" does not apply (wrong action).]
[Rule "redirect to GEP timed activity rule" does not apply (wrong action).]
[Rule "redirect to GEP character input rule" does not apply (wrong action).]
[Rule "redirect to GEP line input rule" applies.]
[Rule "redirect to GEP mouse input rule" does not apply (wrong action).]
[Rule "redirect to GEP arranging rule" does not apply (wrong action).]
[Rule "redirect to GEP redrawing rule" does not apply (wrong action).]
[Rule "redirect to GEP sound notification rule" does not apply (wrong action).]
[Rule "redirect to GEP hyperlink rule" does not apply (wrong action).]
[Rule "ordinary checking for content rule" applies.]
[Rule "After reading a command" applies.]
You can only do that to something animate.

* * *

>kiss button
EXCELLENT! BE SURE TO INSPECT YOUR ENVIRONMENT CAREFULLY!

[Your score has just gone up by five points.]

>kiss mend
You put the MEND alloy in your mouth. Mmmm, tastes like buttercream. You take it out of your mouth out of respect.

AMAZING! YOUR TASTING ABILITIES ARE UNPARALLELED.

[Your score has just gone up by five points.]

* * *

 

 

Supply Room
You are standing in a spacious room made of reinforced concrete. A lighting panel illuminates the room in a tense white glow. There is another room to the SOUTH.

An alcove is carved into the wall in front of you. Hovering in the alcove are a SHIELD alloy, a BLADE alloy, an ENTROPIC alloy, a MEND alloy and a SPARK alloy.

A large red button labeled RESUPPLY is mounted above the alcove.

>kiss me
You smooch yourself on the arm.

>kiss mend
You put the MEND alloy in your mouth. Mmmm, tastes like buttercream. You take it out of your mouth out of respect.

EXCELLENT! BE SURE TO INSPECT YOUR ENVIRONMENT CAREFULLY!

[Your score has just gone up by five points.]

>s
Combination Station
WELCOME TO THE QUALIFICATION DETERMINATION SIMULATION COMBINATION STATION! HERE YOU CAN TAKE ALLOYS FROM THE PREVIOUS ROOM AND FORM THEM INTO NEW AND FANCIFUL CREATIONS. WHAT ARE YOU WAITING FOR? LET'S GET CREATIVE!

You are standing in another concrete room. There are exits to the North and South. In the center is a vast machine labeled 'Combinator'. The machine has 3 slots to put alloys in:

Slot 1 is empty.

Slot 2 is empty.

Slot 3 is empty.

You can also see a green button labelled GO and Intern Jim here.

* * *

 

 

Supply Room
You are standing in a spacious room made of reinforced concrete. A lighting panel illuminates the room in a tense white glow. There is another room to the SOUTH.

An alcove is carved into the wall in front of you. Hovering in the alcove are a SHIELD alloy, a BLADE alloy, an ENTROPIC alloy, a MEND alloy and a SPARK alloy.

A large red button labeled RESUPPLY is mounted above the alcove.

>kiss mend
You can only do that to something animate.

>rules all
Rules tracing now switched to "all". Type "rules off" to switch it off again.

>actions
[Rule "debounce arrange event rule" does not apply (wrong action).]
[Rule "redirect to GEP timed activity rule" does not apply (wrong action).]
[Rule "redirect to GEP character input rule" does not apply (wrong action).]
[Rule "redirect to GEP line input rule" applies.]
[Rule "redirect to GEP mouse input rule" does not apply (wrong action).]
[Rule "redirect to GEP arranging rule" does not apply (wrong action).]
[Rule "redirect to GEP redrawing rule" does not apply (wrong action).]
[Rule "redirect to GEP sound notification rule" does not apply (wrong action).]
[Rule "redirect to GEP hyperlink rule" does not apply (wrong action).]
[Rule "ordinary checking for content rule" applies.]
[Rule "After reading a command" applies.]
[Rule "declare everything initially unmentioned rule" applies.]
Actions listing on.

>kiss mend
[Rule "debounce arrange event rule" does not apply (wrong action).]
[Rule "redirect to GEP timed activity rule" does not apply (wrong action).]
[Rule "redirect to GEP character input rule" does not apply (wrong action).]
[Rule "redirect to GEP line input rule" applies.]
[Rule "redirect to GEP mouse input rule" does not apply (wrong action).]
[Rule "redirect to GEP arranging rule" does not apply (wrong action).]
[Rule "redirect to GEP redrawing rule" does not apply (wrong action).]
[Rule "redirect to GEP sound notification rule" does not apply (wrong action).]
[Rule "redirect to GEP hyperlink rule" does not apply (wrong action).]
[Rule "ordinary checking for content rule" applies.]
[Rule "After reading a command" applies.]
You can only do that to something animate.

* * *

 

 

Supply Room
You are standing in a spacious room made of reinforced concrete. A lighting panel illuminates the room in a tense white glow. There is another room to the SOUTH.

An alcove is carved into the wall in front of you. Hovering in the alcove are a SHIELD alloy, a BLADE alloy, an ENTROPIC alloy, a MEND alloy and a SPARK alloy.

A large red button labeled RESUPPLY is mounted above the alcove.

>lick alcove
That's not a verb I recognise.

>taste wall
You lick the concrete. You think somone once told you this is how you get "stoned."

EXCELLENT! BE SURE TO INSPECT YOUR ENVIRONMENT CAREFULLY!

[Your score has just gone up by five points.]

* * *

 

 

Supply Room
You are standing in a spacious room made of reinforced concrete. A lighting panel illuminates the room in a tense white glow. There is another room to the SOUTH.

An alcove is carved into the wall in front of you. Hovering in the alcove are a SHIELD alloy, a BLADE alloy, an ENTROPIC alloy, a MEND alloy and a SPARK alloy.

A large red button labeled RESUPPLY is mounted above the alcove.

>listen
What do you want to listen?

>haer
You can't see any such thing.

>hear
What do you want to hear?

>hear me
Sounds.

You hear nothing unexpected.

>listen to me
You can't see any such thing.

>listen player
You can't see any such thing.

>listen myself
Sounds.

You hear nothing unexpected.

>listen to myself
You can't see any such thing.

>listen myself
Sounds.

You hear nothing unexpected.

* * *

>listen
What do you want to listen?

>listen to me
You hear the soft hum of Air Conditioning.

>hear
What do you want to hear?

* * *

>listen to me
You hear the soft hum of Air Conditioning.

>listen to button
You can't see any such thing.

>listen button
Sounds.

* * *

>listen to me
You hear the soft hum of Air Conditioning.

>listen to me
You hear a distant refrigerator running.

>listen to me
You hear a cheap cricket sound effect from far off in the distance.

>listen to me
You hear someone whisper "Nyeh heh heh!"

>listen to me
You hear the sound of your own heartbeat.

>listen to me
You hear the sound of your own breathing.

>listen to me
You hear the sound of a clanking machine somewhere.

>listen to me
You don't hear anything in particular.

>listen to me
You hear the sounds of the universe.

>listen to me
You hear the earth moving.

I beg your pardon?

I beg your pardon?

>listen to me
You hear the narrator telling you what you're hearing.

>listen to me
You hear computation.

>listen to me
You hear silence.

>listen to me
You hear the narrator sigh to himself.

>listen to me
You hear computation.

>listen to me
You hear a cheap cricket sound effect from far off in the distance.

>listen to me
You hear the soft hum of Air Conditioning.

>listen to me
You don't hear anything in particular.

* * *

>listen to me
You hear the sounds of the universe.

>listen to me
You hear the sound of your own breathing.

>listen to me
You hear computation.

>listen to me
You hear a distant refrigerator running.

>listen to me
You don't hear anything in particular.

>listen to me
You hear the sound of your own heartbeat.

>listen to me
You hear the sounds of the universe.

>listen to me
You hear someone whisper "Nyeh heh heh!"

>listen to me
You hear a cheap cricket sound effect from far off in the distance.

>listen to me
You hear the narrator telling you what you're hearing.

>listen to me
You hear a distant refrigerator running.

* * *

>listen to me
You don't hear anything in particular.

>listen to me
You hear the soft hum of Air Conditioning.

>listen to me
You hear the narrator sigh to himself.

>listen to me
You hear the earth moving.

>listen to mend
You hear the sound of a clanking machine somewhere.

>listen to blade
You hear the soft hum of Air Conditioning.

>smell concrete
You sniff the concrete. You think someone once told you this is how you get "stoned."

EXCELLENT! BE SURE TO INSPECT YOUR ENVIRONMENT CAREFULLY!

[Your score has just gone up by five points.]

>smell button
AMAZING! YOUR SNIFFING ABILITIES ARE UNPARALLELED.

[Your score has just gone up by five points.]

>s
Combination Station
WELCOME TO THE QUALIFICATION DETERMINATION SIMULATION COMBINATION STATION! HERE YOU CAN TAKE ELEMENTS FROM THE PREVIOUS ROOM AND FORM THEM INTO NEW AND FANCIFUL CREATIONS. WHAT ARE YOU WAITING FOR? LET'S GET CREATIVE!

You are standing in another concrete room. There are exits to the North and South. In the center is a vast machine labeled 'Combinator'. The machine has 3 slots to put elements in:

Slot 1 is empty.

Slot 2 is empty.

Slot 3 is empty.

You can also see a green button labelled GO and Intern Jymm here.

>talk to Jim
That's not a verb I recognise.

>ask jim about jim
You can't see any such thing.

>ask Jim
You can't see any such thing.

>ask Jymm about Jymm
There is no reply.

* * *

 

 

Supply Room
You are standing in a spacious room made of reinforced concrete. A lighting panel illuminates the room in a tense white glow. There is another room to the SOUTH.

An alcove is carved into the wall in front of you. Hovering in the alcove are a SHIELD alloy, a BLADE alloy, an ENTROPIC alloy, a MEND alloy and a SPARK alloy.

A large red button labeled RESUPPLY is mounted above the alcove.

>listen button
I only understood you as far as wanting to listen.

>listen to button
You hear nothing unexpected.

>sniff wall
You sniff the concrete. You think someone once told you this is how you get "stoned."

EXCELLENT! BE SURE TO INSPECT YOUR ENVIRONMENT CAREFULLY!

[Your score has just gone up by five points.]

>sniff light
You can't reach the panel from down here. Instead, you close your eyes and imagine a warm sunrise basking over your tongue.

AMAZING! YOUR SNIFFING ABILITIES ARE UNPARALLELED.

[Your score has just gone up by five points.]

* * *

 

 

Supply Room
You are standing in a spacious room made of reinforced concrete. A lighting panel illuminates the room in a tense white glow. There is another room to the SOUTH.

An alcove is carved into the wall in front of you. Hovering in the alcove are a SHIELD alloy, a BLADE alloy, an ENTROPIC alloy, a MEND alloy and a SPARK alloy.

A large red button labeled RESUPPLY is mounted above the alcove.

>look
Supply Room
You are standing in a spacious room made of reinforced concrete. A lighting panel illuminates the room in a tense white glow. There is another room to the south.

An alcove is carved into the wall in front of you. Hovering in the alcove are a SHIELD alloy, a BLADE alloy, an ENTROPIC alloy, a MEND alloy and a SPARK alloy.

A large red button labeled RESUPPLY is mounted above the alcove.

I beg your pardon?

>l
Workshop
You are standing in a modern-looking laboratory.

>look
Workshop
You are standing in a modern-looking laboratory.

>z
Time passes.

* * *

>look
Supply Room
You are standing in a spacious room made of reinforced concrete. A lighting panel illuminates the room in a tense white glow. There is another room to the south.

An alcove is carved into the wall in front of you. Hovering in the alcove are a SHIELD alloy, a BLADE alloy, an ENTROPIC alloy, a MEND alloy and a SPARK alloy.

A large red button labeled RESUPPLY is mounted above the alcove.

>look
Supply Room
You are standing in a spacious room made of reinforced concrete. A lighting panel illuminates the room in a tense white glow. There is another room to the south.

An alcove is carved into the wall in front of you. Hovering in the alcove are a SHIELD alloy, a BLADE alloy, an ENTROPIC alloy, a MEND alloy and a SPARK alloy.

A large red button labeled RESUPPLY is mounted above the alcove.

>x room
You can't see any such thing.

>x supply room
You can't see any such thing.

>look
Supply Room
You are standing in a spacious room made of reinforced concrete. A lighting panel illuminates the room in a tense white glow. There is another room to the south.

An alcove is carved into the wall in front of you. Hovering in the alcove are a SHIELD alloy, a BLADE alloy, an ENTROPIC alloy, a MEND alloy and a SPARK alloy.

A large red button labeled RESUPPLY is mounted above the alcove.

>x
What do you want to examine?

>x me
As good-looking as ever.

I ADMIRE YOUR INQUISITIVE NATURE!

[Your score has just gone up by five points.]

* * *

>look
Supply Room
You are standing in a spacious room made of reinforced concrete. A lighting panel illuminates the room in a tense white glow. There is another room to the south.

An alcove is carved into the wall in front of you. Hovering in the alcove are a SHIELD alloy, a BLADE alloy, an ENTROPIC alloy, a MEND alloy and a SPARK alloy.

A large red button labeled RESUPPLY is mounted above the alcove.

>s
Combination Station
WELCOME TO THE QUALIFICATION DETERMINATION SIMULATION COMBINATION STATION! HERE YOU CAN TAKE ELEMENTS FROM THE PREVIOUS ROOM AND FORM THEM INTO NEW AND FANCIFUL CREATIONS. WHAT ARE YOU WAITING FOR? LET'S GET CREATIVE!

You are standing in another concrete room. There are exits to the North and South. In the center is a vast machine labeled 'Combinator'. The machine has 3 slots to put elements in:

Slot 1 is empty.

Slot 2 is empty.

Slot 3 is empty.

You can also see a green button labelled GO and Intern Jim here.

The entity suddenly leaps up and clings to the ceiling. Its face changes to an expression of confusion.
.

>s
Arena
STUDIES HAVE SHOWN THAT CREATIVITY IS BOOSTED BY 57% UPON THE INTRODUCTION OF A HOSTILE ENTITY! THUS, WE HAVE PROVIDED AN ENEMY FOR YOU TO DEFEAT IN THIS ROOM. PRESS THE BUTTON WHEN YOU FEEL YOU ARE READY TO FIGHT IT!

This is another large, barren concrete room. Exits are to the north and south.

There is a twitching cube made of twisted limbs floating in the center of the room.

The entity stares at you. You feel a dull ache in the base of your spine.
.

* * *

>look
Supply Room
You are standing in a spacious room made of reinforced concrete. A lighting panel illuminates the room in a tense white glow. There is another room to the south.

An alcove is carved into the wall in front of you. Hovering in the alcove are a SHIELD alloy, a BLADE alloy, an ENTROPIC alloy, a MEND alloy and a SPARK alloy.

A large red button labeled RESUPPLY is mounted above the alcove.

>x alcove
A rectangular hole is carved out of the stone in front of you. It seems to be where the Alloys respawn if you press the RESET button.

* * *

 

 

Supply Room
You are standing in a spacious room made of reinforced concrete. A lighting panel illuminates the room in a tense white glow. There is another room to the SOUTH.

An alcove is carved into the wall in front of you. Hovering in the alcove are a SHIELD alloy, a BLADE alloy, an ENTROPIC alloy, a MEND alloy and a SPARK alloy.

A large red button labeled RESUPPLY is mounted above the alcove.

>look lihgting
You can't see any such thing.

>look lighting
You see nothing special about lighting.

>look light
You can't see any such thing.

* * *

 

 

Supply Room
You are standing in a spacious room made of reinforced concrete. A lighting panel illuminates the room in a tense white glow. There is another room to the SOUTH.

An alcove is carved into the wall in front of you. Hovering in the alcove are a SHIELD alloy, a BLADE alloy, an ENTROPIC alloy, a MEND alloy and a SPARK alloy.

A large red button labeled RESUPPLY is mounted above the alcove.

>look rating_module
You see nothing special about the HOW DID YOU FIND ME >_> GO AWAY.

* * *

 

 

Supply Room
You are standing in a spacious room made of reinforced concrete. A lighting panel illuminates the room in a tense white glow. There is another room to the SOUTH.

An alcove is carved into the wall in front of you. Hovering in the alcove are a SHIELD alloy, a BLADE alloy, an ENTROPIC alloy, a MEND alloy and a SPARK alloy.

A large red button labeled RESUPPLY is mounted above the alcove.

>look shield
A fist-sized cube of pure SHIELD alloy is hovering in front of you. It seems eager to morph into something useful.

I ADMIRE YOUR INQUISITIVE NATURE!

[Your score has just gone up by five points.]

>eat alcove
You lick the concrete. You think someone once told you this is how you get "stoned."

EXCELLENT! BE SURE TO INSPECT YOUR ENVIRONMENT CAREFULLY!

[Your score has just gone up by five points.]

>eat wall
You lick the concrete. You think someone once told you this is how you get "stoned."

AMAZING! YOUR TASTING ABILITIES ARE UNPARALLELED.

[Your score has just gone up by five points.]

* * *

>look shield
A fist-sized cube of pure SHIELD alloy is hovering in front of you. It seems eager to morph into something useful.

I ADMIRE YOUR INQUISITIVE NATURE!

[Your score has just gone up by five points.]

>look blade
A sheet of pure BLADE alloy hovers in front of you, light glinting dangerously off its surface. It seems eager to morph into something sharp.

I ADMIRE YOUR EXPLORATORY NATURE!

[Your score has just gone up by five points.]

>look entropic
A writhing ball of pure ENTROPY hovers in front of you. It hurts to look at.

I ADMIRE YOUR EXPLORATORY SPIRIT!

[Your score has just gone up by five points.]

>look entropic
rate 4 stars
THANK YOU FOR YOUR FEEDBACK!

>look
Supply Room
You are standing in a spacious room made of reinforced concrete. A lighting panel illuminates the room in a tense white glow. There is another room to the south.

An alcove is carved into the wall in front of you. Hovering in the alcove are a SHIELD alloy, a BLADE alloy, an ENTROPIC alloy, a MEND alloy and a SPARK alloy.

A large red button labeled RESUPPLY is mounted above the alcove.

>look spark
rate 1 stars
THE RATING MODULE RAN AWAY... IT USUALLY LIKES HIDING DOWN BY THE STRING TABLES IN MAIN MEMORY, SO IT'LL PROBABLY BE FINE. IN THE MEANTIME, HOLD OFF ON RATING ANYTHING.

* * *

 

 

Supply Room
You are standing in a spacious room made of reinforced concrete. A lighting panel illuminates the room in a tense white glow. There is another room to the SOUTH.

An alcove is carved into the wall in front of you. Hovering in the alcove are a SHIELD alloy, a BLADE alloy, an ENTROPIC alloy, a MEND alloy and a SPARK alloy.

A large red button labeled RESUPPLY is mounted above the alcove.

>press button
You press the button, with a satisfying "click."

*BZZZZZ* ALL THE ALLOYS ARE ALREADY IN THIS ROOM. IF YOU USE ONE UP YOU CAN BRING IT BACK WITH THIS BUTTON!

>pick up blade alloy
Taken.

>eat blade alloy
You gingerly move to lick the BLADE alloy. Ow! It smacks your face with its flat side.

EXCELLENT! BE SURE TO INSPECT YOUR ENVIRONMENT CAREFULLY!

[Your score has just gone up by five points.]

>throw blade alloy
Dropped.

>pick it up
Taken.

>run
You'll have to say which compass direction to go in.

>run NORTH
You can't go that way.

>run south
Combination Station
WELCOME TO THE QUALIFICATION DETERMINATION SIMULATION COMBINATION STATION! HERE YOU CAN TAKE ALLOYS FROM THE PREVIOUS ROOM AND FORM THEM INTO NEW AND FANCIFUL CREATIONS. WHAT ARE YOU WAITING FOR? LET'S GET CREATIVE!

You are standing in another concrete room. There are exits to the North and South. In the center is a vast machine labeled 'Combinator'. The machine has 3 slots to put alloys in:

Slot 1 is empty.

Slot 2 is empty.

Slot 3 is empty.

You can also see a green button labelled GO and Intern Jim here.

>eat intern jim
You and Jim share a passionate kiss. He cradles the back of your head with his hand and whispers something to you. The hairs on the back of your neck stand up.

AMAZING! YOUR TASTING ABILITIES ARE UNPARALLELED.

[Your score has just gone up by five points.]

>put alloy into slot 1
You put the BLADE alloy into slot 1.

>go north
Supply Room
You are standing in a spacious room made of reinforced concrete. A lighting panel illuminates the room in a tense white glow. There is another room to the SOUTH.

An alcove is carved into the wall in front of you. Hovering in the alcove are a SHIELD alloy, an ENTROPIC alloy, a MEND alloy and a SPARK alloy.

A large red button labeled RESUPPLY is mounted above the alcove.

>take entropic alloy
Taken.

>take mend alloy
Taken.

>go south
Combination Station

You are standing in another concrete room. There are exits to the North and South. In the center is a vast machine labeled 'Combinator'. The machine has 3 slots to put alloys in:

Slot 1 contains a BLADE alloy.

Slot 2 is empty.

Slot 3 is empty.

You can also see a green button labelled GO and Intern Jim here.

>put entropic alloy in slot 2
You put the ENTROPIC alloy into slot 2.

>put myself into slot 3
(first taking yourself)
You are always self-possessed.

>put intern jim into slot 3
(first taking Intern Jim)
I don't suppose Intern Jim would care for that.

>touch intern jim
EXCELLENT! BE SURE TO INSPECT YOUR ENVIRONMENT CAREFULLY!

[Your score has just gone up by five points.]

>kick intern jim
That's not a verb I recognise.

>attack intern jim
You attack Intern Jim, causing 10 points of damage!

Intern Jim expires, and is immediately carried away by the Arena slaves!

>l
Combination Station

You are standing in another concrete room. There are exits to the North and South. In the center is a vast machine labeled 'Combinator'. The machine has 3 slots to put alloys in:

Slot 1 contains a BLADE alloy.

Slot 2 contains an ENTROPIC alloy.

Slot 3 is empty.

You can also see a green button labelled GO and Intern Jim here.

>abstract jim to combination station
(Combination Station)
[Abstracted.]

>l
Combination Station

You are standing in another concrete room. There are exits to the North and South. In the center is a vast machine labeled 'Combinator'. The machine has 3 slots to put alloys in:

Slot 1 contains a BLADE alloy.

Slot 2 contains an ENTROPIC alloy.

Slot 3 is empty.

You can also see Intern Jim and a green button labelled GO here.

>put mend alloy in slot 3
You put the MEND alloy into slot 3.

>press go
Ingredient list: BLADE alloy, ENTROPIC alloy and MEND alloy

The BLADE alloy warps itself into a long syringe, and the MEND alloy fills it with a healing light! But then, the ENTROPIC alloy corrupts it into a nasty-looking poison!

AMAZING! THAT'S AN INCREDIBLE POISON NEEDLE YOU'VE JUST CREATED! I'M AWARDING YOU 20 CREATIVITY POINTS FOR IT.

You now carry a brand-new poison needle.

[Your score has just gone up by twenty points.]

>eat poison needle
You gingerly touch the needle to your tongue. A drop of poison gets on your tongue and burns it! Ow!

NICE! SEEING YOU TASTE THAT poison needle GAVE ME A VICARIOUS THRILL!

You feel the entropic energy course course through your bloodstream, searing your insides!
You take 7 damage.
You shudder as the last of the poison leaves your system.

[Your score has just gone up by five points.]

>l
Combination Station

You are standing in another concrete room. There are exits to the North and South. In the center is a vast machine labeled 'Combinator'. The machine has 3 slots to put alloys in:

Slot 1 is empty.

Slot 2 is empty.

Slot 3 is empty.

You can also see Intern Jim and a green button labelled GO here.

>x self
As good-looking as ever.

I ADMIRE YOUR INQUISITIVE NATURE!

[Your score has just gone up by five points.]

>go south
Arena
STUDIES HAVE SHOWN THAT CREATIVITY IS BOOSTED BY 57% UPON THE INTRODUCTION OF A HOSTILE ENTITY! THUS, WE HAVE PROVIDED AN ENEMY FOR YOU TO DEFEAT IN THIS ROOM. PRESS THE BUTTON WHEN YOU FEEL YOU ARE READY TO FIGHT IT!

This is another large, barren concrete room. Exits are to the north and south.

There is a hostile entity trapped by a force field on the other half of the room from you.

The entity grins at you. Well, not so much "grin" as "curl back its lips and roll its eyes back into its head."

>touch force field
You place your hand against the field. It feels like hardened air - you don't feel anything solid against your hand but it won't move any further than the very middle of the room.

AMAZING! YOUR TACTILE ABILITIES ARE UNPARALLELED.

The entity ripples, as if a giant worm is crawling around just under the surface of its skin.

[Your score has just gone up by five points.]

>laugh at entity
That's not a verb I recognise.

>shout at entity
(to the hostile entity)
There is no reply.

The entity gurgles softly to itself, and jams a finger into its own eye.

>eat own fingers
You can't see any such thing.

>press button
Suddenly, blue waves ripple across the air in the center of the room, revealing the barrier. It dissolves with a final shimmer.

The entity makes a guttural clicking sound and scuttles across the floor towards you!

The entity grabs you by both shoulders and unhinges its jaw, releasing a cloud of caustic black smoke. You cough and choke as the black smoke fills you with poison. It feels like your insides are on fire.

You feel the entropic energy course course through your bloodstream, searing your insides!
You take 5 damage.

>throw needle
Dropped.

The entity attacks you, causing 17 points of damage!

You feel the entropic energy course course through your bloodstream, searing your insides!
You take 10 damage.

>pick up needle
Taken.

The entity attacks you, causing 17 points of damage!

You feel the entropic energy course course through your bloodstream, searing your insides!
You take 5 damage.
You shudder as the last of the poison leaves your system.

>throw needle at entity
You hold the poison needle like a dart and throw it at the hostile entity.
Bullseye! The needle stabs the hostile entity and gets some of the poison into his bloodstream. The needle falls to the ground and shatters.

GOOD THROWING ARM! I DON'T HAVE ARMS, SO THAT'S ESPECIALLY IMPRESSIVE.

The entity grabs you by both shoulders and unhinges its jaw, releasing a cloud of caustic black smoke. You cough and choke as the black smoke fills you with poison. It feels like your insides are on fire.

You feel the entropic energy course course through your bloodstream, searing your insides!
You take 8 damage.

[Your score has just gone up by five points.]

>inject poison into entity
That's not a verb I recognise.

>kick entity
That's not a verb I recognise.

>attack entity
You attack the hostile entity, causing 5 points of damage!

The entity attacks you, causing 18 points of damage!

You feel the entropic energy course course through your bloodstream, searing your insides!
You take 9 damage.

>kiss entity
AMAZING! YOUR TASTING ABILITIES ARE UNPARALLELED.

The entity attacks you, causing 18 points of damage!

You fall down dead.

HUMAN! YOU HAVE GOTTEN YOURSELF KILLED! IF YOU CAN'T DEFEAT THE ENTITY, TRY TO MAKE MORE ITEMS IN THE COMBINATOR, AND "USE" THE ITEMS YOU ALREADY HAVE! REMEMBER TO BE CREATIVE!

I'VE RESET YOU BACK TO THE COMBINATION STATION!

Combination Station

You are standing in another concrete room. There are exits to the North and South. In the center is a vast machine labeled 'Combinator'. The machine has 3 slots to put alloys in:

Slot 1 is empty.

Slot 2 is empty.

Slot 3 is empty.

You can also see Intern Jim and a green button labelled GO here.

[Your score has just gone up by five points.]

>go north
Supply Room
You are standing in a spacious room made of reinforced concrete. A lighting panel illuminates the room in a tense white glow. There is another room to the SOUTH.

An alcove is carved into the wall in front of you. Hovering in the alcove are a SHIELD alloy and a SPARK alloy.

A large red button labeled RESUPPLY is mounted above the alcove.

>s
Combination Station

You are standing in another concrete room. There are exits to the North and South. In the center is a vast machine labeled 'Combinator'. The machine has 3 slots to put alloys in:

Slot 1 is empty.

Slot 2 is empty.

Slot 3 is empty.

You can also see Intern Jim and a green button labelled GO here.

>go
You'll have to say which compass direction to go in.

>press go
There are 3 slots that don't have an alloy in them! Please put another alloy in before you press GO.

>n
Supply Room
You are standing in a spacious room made of reinforced concrete. A lighting panel illuminates the room in a tense white glow. There is another room to the SOUTH.

An alcove is carved into the wall in front of you. Hovering in the alcove are a SHIELD alloy and a SPARK alloy.

A large red button labeled RESUPPLY is mounted above the alcove.

>pick up shield alloy
Taken.

>take spark
Taken.

>press button
You press the button, with a satisfying "click."
A BLADE alloy teleports in!
An ENTROPIC alloy zaps in!
A MEND alloy warps in!

>take blade
Taken.

>s
Combination Station

You are standing in another concrete room. There are exits to the North and South. In the center is a vast machine labeled 'Combinator'. The machine has 3 slots to put alloys in:

Slot 1 is empty.

Slot 2 is empty.

Slot 3 is empty.

You can also see Intern Jim and a green button labelled GO here.

>press go
There are 3 slots that don't have an alloy in them! Please put another alloy in before you press GO.

>combine
Combination Station

You are standing in another concrete room. There are exits to the North and South. In the center is a vast machine labeled 'Combinator'. The machine has 3 slots to put alloys in:

Slot 1 is empty.

Slot 2 is empty.

Slot 3 is empty.

You can also see Intern Jim and a green button labelled GO here.

You walk to the Combination Station.

You put the SHIELD alloy into slot 1.

Slot 1 is full, so let's put BLADE alloy in slot 2. You put the BLADE alloy into slot 2.

Slot 1 is full, so let's put SPARK alloy in slot 2. Slot 2 is full, so let's put SPARK alloy in slot 3. You put the SPARK alloy into slot 3.

Ingredient list: BLADE alloy, SHIELD alloy and SPARK alloy

The SHIELD alloy warps into a sturdy set of armor, and the BLADE alloy affixes it with deadly spikes! The SPARK alloy jumps in and ensures that the spikes only hurt people that are trying to kill you.

AMAZING! THAT'S AN INCREDIBLE CHESTPLATE OF RETRIBUTION YOU'VE JUST CREATED! I'M AWARDING YOU 20 CREATIVITY POINTS FOR IT.

You now carry a brand-new chestplate of retribution.

[Your score has just gone up by twenty points.]

>go south
Arena

This is another large, barren concrete room. Exits are to the north and south.

You can see a hostile entity here.

The entity attacks you, causing 14 points of damage!

* * *

I beg your pardon?

>z
Time passes.

The entity attacks you, causing 15 points of damage!

>z
Time passes.

The entity attacks you, causing 19 points of damage!

>z
Time passes.

The entity attacks you, causing 13 points of damage!

>z
Time passes.

The entity grabs you by both shoulders and unhinges its jaw, releasing a cloud of caustic black smoke. You cough and choke as the black smoke fills you with poison. It feels like your insides are on fire.

You feel the entropic energy course course through your bloodstream, searing your insides!
You take 5 damage.

>z
Time passes.

The entity attacks you, causing 15 points of damage!

You feel the entropic energy course course through your bloodstream, searing your insides!
You take 5 damage.

>z
Time passes.

The entity attacks you, causing 14 points of damage!

You fall down dead.

HUMAN! YOU HAVE GOTTEN YOURSELF KILLED! IF YOU CAN'T DEFEAT THE ENTITY, TRY TO MAKE MORE ITEMS IN THE COMBINATOR, AND "USE" THE ITEMS YOU ALREADY HAVE! REMEMBER TO BE CREATIVE!

I'VE RESET YOU BACK TO THE COMBINATION STATION!

Combination Station

You are standing in another concrete room. There are exits to the North and South. In the center is a vast machine labeled 'Combinator'. The machine has 3 slots to put alloys in:

Slot 1 is empty.

Slot 2 is empty.

Slot 3 is empty.

You can also see Intern Jim and a green button labelled GO here.

>z
Time passes.

>n
Supply Room
You are standing in a spacious room made of reinforced concrete. A lighting panel illuminates the room in a tense white glow. There is another room to the SOUTH.

An alcove is carved into the wall in front of you. Hovering in the alcove are a MEND alloy and an ENTROPIC alloy.

A large red button labeled RESUPPLY is mounted above the alcove.

>press button
You press the button, with a satisfying "click."
A SHIELD alloy pops into existence!
A BLADE alloy respawns!
A SPARK alloy warps in!

>take shield
Taken.

>take blade
Taken.

>take entropic
Taken.

>s
Combination Station

You are standing in another concrete room. There are exits to the North and South. In the center is a vast machine labeled 'Combinator'. The machine has 3 slots to put alloys in:

Slot 1 is empty.

Slot 2 is empty.

Slot 3 is empty.

You can also see Intern Jim and a green button labelled GO here.

>combine
Combination Station

You are standing in another concrete room. There are exits to the North and South. In the center is a vast machine labeled 'Combinator'. The machine has 3 slots to put alloys in:

Slot 1 is empty.

Slot 2 is empty.

Slot 3 is empty.

You can also see Intern Jim and a green button labelled GO here.

You walk to the Combination Station.

You put the SHIELD alloy into slot 1.

Slot 1 is full, so let's put BLADE alloy in slot 2. You put the BLADE alloy into slot 2.

Slot 1 is full, so let's put ENTROPIC alloy in slot 2. Slot 2 is full, so let's put ENTROPIC alloy in slot 3. You put the ENTROPIC alloy into slot 3.

Ingredient list: BLADE alloy, ENTROPIC alloy and SHIELD alloy

The SHIELD alloy quickly wraps itself around the volatile ENTROPIC alloy. Then, the BLADE alloy adds dangerous-looking spikes to the outside of the resulting ball.

AMAZING! THAT'S AN INCREDIBLE SPIKED GRENADE YOU'VE JUST CREATED! I'M AWARDING YOU 20 CREATIVITY POINTS FOR IT.

You now carry a brand-new spiked grenade.

You now carry a brand-new chestplate of retribution.

[Your score has just gone up by twenty points.]

I beg your pardon?

>s
Arena

This is another large, barren concrete room. Exits are to the north and south.

You can see a hostile entity here.

The entity attacks you, causing 16 points of damage!

>throw grenade
Dropped.

The entity attacks you, causing 19 points of damage!

>pick up grenade
Taken.

The entity attacks you, causing 12 points of damage!

>throw grenade at entity
You throw the spiked grenade at the hostile entity. Bonk! The spiked grenade lands on the floor.

The entity grabs you by both shoulders and unhinges its jaw, releasing a cloud of caustic black smoke. You cough and choke as the black smoke fills you with poison. It feels like your insides are on fire.

You feel the entropic energy course course through your bloodstream, searing your insides!
You take 8 damage.

>attack entity
You attack the hostile entity, causing 7 points of damage!

The entity grabs you by both shoulders and unhinges its jaw, releasing a cloud of caustic black smoke. You cough and choke as the black smoke fills you with poison. It feels like your insides are on fire.

You feel the entropic energy course course through your bloodstream, searing your insides!
You take 8 damage.

>attack entity
You attack the hostile entity, causing 7 points of damage!

The entity attacks you, causing 16 points of damage!

You feel the entropic energy course course through your bloodstream, searing your insides!
You take 6 damage.

>attack entity
You attack the hostile entity, causing 6 points of damage!

The entity attacks you, causing 13 points of damage!

You feel the entropic energy course course through your bloodstream, searing your insides!
You take 10 damage.
You shudder as the last of the poison leaves your system.

>attack entity
You attack the hostile entity, causing 6 points of damage!

The entity attacks you, causing 20 points of damage!

You fall down dead.

HUMAN! YOU HAVE GOTTEN YOURSELF KILLED! IF YOU CAN'T DEFEAT THE ENTITY, TRY TO MAKE MORE ITEMS IN THE COMBINATOR, AND "USE" THE ITEMS YOU ALREADY HAVE! REMEMBER TO BE CREATIVE!

I'VE RESET YOU BACK TO THE COMBINATION STATION!

Combination Station

You are standing in another concrete room. There are exits to the North and South. In the center is a vast machine labeled 'Combinator'. The machine has 3 slots to put alloys in:

Slot 1 is empty.

Slot 2 is empty.

Slot 3 is empty.

You can also see Intern Jim and a green button labelled GO here.

* * *

>press button
You press the button, with a satisfying "click."

*BZZZZZ* ALL THE ALLOYS ARE ALREADY IN THIS ROOM. IF YOU USE ONE UP YOU CAN BRING IT BACK WITH THIS BUTTON!

>take mend and spark
MEND alloy: Test this
Taken.
SPARK alloy: Test 
Taken.

>s
Combination Station
WELCOME TO THE QUALIFICATION DETERMINATION SIMULATION COMBINATION STATION! HERE YOU CAN TAKE ELEMENTS FROM THE PREVIOUS ROOM AND FORM THEM INTO NEW AND FANCIFUL CREATIONS. WHAT ARE YOU WAITING FOR? LET'S GET CREATIVE!

You are standing in another concrete room. There are exits to the North and South. In the center is a vast machine labeled 'Combinator'. The machine has 3 slots to put elements in:

Slot 1 contains nothing.

>put mend in slot
You put the MEND alloy into slot 1.

>put spark in 1
That slot already has nothing in it.

* * *

>press button
You press the button, with a satisfying "click."

*BZZZZZ* ALL THE ALLOYS ARE ALREADY IN THIS ROOM. IF YOU USE ONE UP YOU CAN BRING IT BACK WITH THIS BUTTON!

>x button
A glowing red button. PRESS THIS BUTTON IF YOU NEED MORE ALLOYS.

I ADMIRE YOUR INQUISITIVE NATURE!

[Your score has just gone up by five points.]

* * *

 

 

Supply Room
You are standing in a spacious room made of reinforced concrete. A lighting panel illuminates the room in a tense white glow. There is another room to the SOUTH.

An alcove is carved into the wall in front of you. Hovering in the alcove are a SHIELD alloy, a BLADE alloy, an ENTROPIC alloy, a MEND alloy and a SPARK alloy.

A large red button labeled RESUPPLY is mounted above the alcove.

>push button
You press the button, with a satisfying "click."
*BZZZZZ* ALL THE ALLOYS ARE ALREADY IN THIS ROOM. IF YOU USE ONE UP YOU CAN BRING IT BACK WITH THIS BUTTON!

>push spark
That's not a button.

>touch spark
You feel nothing unexpected.

* * *

 

 

Supply Room
You are standing in a spacious room made of reinforced concrete. A lighting panel illuminates the room in a tense white glow. There is another room to the SOUTH.

An alcove is carved into the wall in front of you. Hovering in the alcove are a SHIELD alloy, a BLADE alloy, an ENTROPIC alloy, a MEND alloy and a SPARK alloy.

A large red button labeled RESUPPLY is mounted above the alcove.

>rate
I didn't understand that sentence.

>rate 5 stars
LOL good rating 5 stars

* * *

 

 

Supply Room
You are standing in a spacious room made of reinforced concrete. A lighting panel illuminates the room in a tense white glow. There is another room to the SOUTH.

An alcove is carved into the wall in front of you. Hovering in the alcove are a SHIELD alloy, a BLADE alloy, an ENTROPIC alloy, a MEND alloy and a SPARK alloy.

A large red button labeled RESUPPLY is mounted above the alcove.

>rate 0 stars
WE DIDN'T ASK YOU TO RATE ANYTHING YET! I ADMIRE YOUR FORWARD THINKING, THOUGH.
YOU KNOW WHAT, I'LL GIVE YOU 10 POINTS FOR THAT. IT WAS IMPRESSIVE.

[Your score has just gone up by ten points.]

>thanks paps
That's not a verb I recognise.

* * *

 

 

Supply Room
You are standing in a spacious room made of reinforced concrete. A lighting panel illuminates the room in a tense white glow. There is another room to the SOUTH.

An alcove is carved into the wall in front of you. Hovering in the alcove are a SHIELD alloy, a BLADE alloy, an ENTROPIC alloy, a MEND alloy and a SPARK alloy.

A large red button labeled RESUPPLY is mounted above the alcove.

>rate 1 stars
LOL good rating 1 starsWE DIDN'T ASK YOU TO RATE ANYTHING YET! I ADMIRE YOUR FORWARD THINKING, THOUGH.
YOU KNOW WHAT, I'LL GIVE YOU 10 POINTS FOR THAT. IT WAS IMPRESSIVE.

[Your score has just gone up by ten points.]

* * *

 

 

Supply Room
You are standing in a spacious room made of reinforced concrete. A lighting panel illuminates the room in a tense white glow. There is another room to the SOUTH.

An alcove is carved into the wall in front of you. Hovering in the alcove are a SHIELD alloy, a BLADE alloy, an ENTROPIC alloy, a MEND alloy and a SPARK alloy.

A large red button labeled RESUPPLY is mounted above the alcove.

>rate 3 stars
WE DIDN'T ASK YOU TO RATE ANYTHING YET! I ADMIRE YOUR FORWARD THINKING, THOUGH.
YOU KNOW WHAT, I'LL GIVE YOU 10 POINTS FOR THAT. IT WAS IMPRESSIVE.

[Your score has just gone up by ten points.]

* * *

 

 

Supply Room
You are standing in a spacious room made of reinforced concrete. A lighting panel illuminates the room in a tense white glow. There is another room to the SOUTH.

An alcove is carved into the wall in front of you. Hovering in the alcove are a SHIELD alloy, a BLADE alloy, an ENTROPIC alloy, a MEND alloy and a SPARK alloy.

A large red button labeled RESUPPLY is mounted above the alcove.

>rate 5 stars
OH NO! YOU'VE TERRIFIED THE RATING MODULE WITH YOUR PERFECT SCORE! NOW IT THINKS IT CAN NEVER LIVE UP TO THE GLORY IT'S ACHIEVED FROM YOUR OVERLY PERFECTIONIST RATING. THE RATING MODULE RAN AWAY!

>abstrast r_state of rating_module to rate_rating
That's not a verb I recognise.

>abstract r_state of rating_module to rate_rating
There seems to be no such object anywhere in the model world.

>x rating_module
You see nothing special about the HOW DID YOU FIND ME >_> GO AWAY.

>x rating
You can't see any such thing.

* * *

>rate 5 stars
OH NO! YOU'VE TERRIFIED THE RATING MODULE WITH YOUR PERFECT SCORE! NOW IT THINKS IT CAN NEVER LIVE UP TO THE GLORY IT'S ACHIEVED FROM YOUR OVERLY PERFECTIONIST RATING. THE RATING MODULE RAN AWAY!

>rate 5 stars
THE RATING MODULE RAN AWAY... IT USUALLY LIKES HIDING DOWN BY THE STRING TABLES IN MAIN MEMORY, SO IT'LL PROBABLY BE FINE. IN THE MEANTIME, HOLD OFF ON RATING ANYTHING.

* * *

 

 

Supply Room
You are standing in a spacious room made of reinforced concrete. A lighting panel illuminates the room in a tense white glow. There is another room to the SOUTH.

An alcove is carved into the wall in front of you. Hovering in the alcove are a SHIELD alloy, a BLADE alloy, an ENTROPIC alloy, a MEND alloy and a SPARK alloy.

A large red button labeled RESUPPLY is mounted above the alcove.

>rules
Rules tracing now switched on. Type "rules off" to switch it off again, or "rules all" to include even rules which do not apply.

>rules all
[Rule "redirect to GEP line input rule" applies.]
[Rule "ordinary checking for content rule" applies.]
[Rule "declare everything initially unmentioned rule" applies.]
Rules tracing now switched to "all". Type "rules off" to switch it off again.

>z
[Rule "debounce arrange event rule" does not apply (wrong action).]
[Rule "redirect to GEP timed activity rule" does not apply (wrong action).]
[Rule "redirect to GEP character input rule" does not apply (wrong action).]
[Rule "redirect to GEP line input rule" applies.]
[Rule "redirect to GEP mouse input rule" does not apply (wrong action).]
[Rule "redirect to GEP arranging rule" does not apply (wrong action).]
[Rule "redirect to GEP redrawing rule" does not apply (wrong action).]
[Rule "redirect to GEP sound notification rule" does not apply (wrong action).]
[Rule "redirect to GEP hyperlink rule" does not apply (wrong action).]
[Rule "ordinary checking for content rule" applies.]
[Rule "declare everything initially unmentioned rule" applies.]
[Rule "announce items from multiple object lists rule" applies.]
[Rule "set pronouns from items from multiple object lists rule" applies.]
[Rule "before stage rule" applies.]
[Rule "don't ignore the rating module rule" applies.]
[Rule "instead stage rule" applies.]
[Rule "investigate player's awareness before action rule" applies.]
[Rule "player aware of his own actions rule" applies.]
[Rule "check stage rule" applies.]
[Rule "carry out stage rule" applies.]
[Rule "after stage rule" applies.]
[Rule "investigate player's awareness after action rule" applies.]
[Rule "report stage rule" applies.]
[Rule "standard report waiting rule" applies.]
Time passes.
[Rule "last specific action-processing rule" applies.]

[Rule "A first turn sequence rule" applies.]
[Rule "every turn stage rule" applies.]
[Rule "A last turn sequence rule" applies.]
[Rule "notify score changes rule" applies.]

>z
[Rule "debounce arrange event rule" does not apply (wrong action).]
[Rule "redirect to GEP timed activity rule" does not apply (wrong action).]
[Rule "redirect to GEP character input rule" does not apply (wrong action).]
[Rule "redirect to GEP line input rule" applies.]
[Rule "redirect to GEP mouse input rule" does not apply (wrong action).]
[Rule "redirect to GEP arranging rule" does not apply (wrong action).]
[Rule "redirect to GEP redrawing rule" does not apply (wrong action).]
[Rule "redirect to GEP sound notification rule" does not apply (wrong action).]
[Rule "redirect to GEP hyperlink rule" does not apply (wrong action).]
[Rule "ordinary checking for content rule" applies.]
[Rule "declare everything initially unmentioned rule" applies.]
[Rule "announce items from multiple object lists rule" applies.]
[Rule "set pronouns from items from multiple object lists rule" applies.]
[Rule "before stage rule" applies.]
[Rule "don't ignore the rating module rule" applies.]
[Rule "instead stage rule" applies.]
[Rule "investigate player's awareness before action rule" applies.]
[Rule "player aware of his own actions rule" applies.]
[Rule "check stage rule" applies.]
[Rule "carry out stage rule" applies.]
[Rule "after stage rule" applies.]
[Rule "investigate player's awareness after action rule" applies.]
[Rule "report stage rule" applies.]
[Rule "standard report waiting rule" applies.]
Time passes.
[Rule "last specific action-processing rule" applies.]

[Rule "A first turn sequence rule" applies.]
[Rule "every turn stage rule" applies.]
[Rule "A last turn sequence rule" applies.]
[Rule "notify score changes rule" applies.]

>z
[Rule "debounce arrange event rule" does not apply (wrong action).]
[Rule "redirect to GEP timed activity rule" does not apply (wrong action).]
[Rule "redirect to GEP character input rule" does not apply (wrong action).]
[Rule "redirect to GEP line input rule" does not apply (wrong action).]
[Rule "redirect to GEP mouse input rule" does not apply (wrong action).]
[Rule "redirect to GEP arranging rule" does not apply (wrong action).]
[Rule "redirect to GEP redrawing rule" does not apply (wrong action).]
[Rule "redirect to GEP sound notification rule" does not apply (wrong action).]
[Rule "redirect to GEP hyperlink rule" applies.]
[Rule "default hyperlink setting rule" applies.]
[Rule "default command replacement by hyperlinks rule" applies.]
[Rule "ordinary checking for content rule" applies.]
[Rule "cancelling input in the main window rule" applies.]
[Rule "print text to the input prompt rule" applies.]
rate 5 stars
[Rule "glue replacement command into parse buffer rule" applies.]
[Rule "declare everything initially unmentioned rule" applies.]
[Rule "announce items from multiple object lists rule" applies.]
[Rule "set pronouns from items from multiple object lists rule" applies.]
[Rule "before stage rule" applies.]
[Rule "don't ignore the rating module rule" does not apply (wrong action).]
[Rule "instead stage rule" applies.]
[Rule "investigate player's awareness before action rule" applies.]
[Rule "player aware of his own actions rule" applies.]
[Rule "check stage rule" applies.]
[Rule "carry out stage rule" applies.]
[Rule "after stage rule" applies.]
[Rule "investigate player's awareness after action rule" applies.]
[Rule "report stage rule" applies.]
[Rule "Report giverating" applies.]
YOU ALREADY RATED THIS ASPECT! THANK YOU FOR YOUR COMMITMENT TO THOROUGH CUSTOMER FEEDBACK.
[Rule "last specific action-processing rule" applies.]

[Rule "A first turn sequence rule" applies.]
[Rule "every turn stage rule" applies.]
[Rule "A last turn sequence rule" applies.]
[Rule "notify score changes rule" applies.]

[Rule "debounce arrange event rule" does not apply (wrong action).]
[Rule "redirect to GEP timed activity rule" does not apply (wrong action).]
[Rule "redirect to GEP character input rule" does not apply (wrong action).]
[Rule "redirect to GEP line input rule" applies.]
[Rule "redirect to GEP mouse input rule" does not apply (wrong action).]
[Rule "redirect to GEP arranging rule" does not apply (wrong action).]
[Rule "redirect to GEP redrawing rule" does not apply (wrong action).]
[Rule "redirect to GEP sound notification rule" does not apply (wrong action).]
[Rule "redirect to GEP hyperlink rule" does not apply (wrong action).]
[Rule "ordinary checking for content rule" applies.]
I beg your pardon?

>rate 5 stars
[Rule "debounce arrange event rule" does not apply (wrong action).]
[Rule "redirect to GEP timed activity rule" does not apply (wrong action).]
[Rule "redirect to GEP character input rule" does not apply (wrong action).]
[Rule "redirect to GEP line input rule" applies.]
[Rule "redirect to GEP mouse input rule" does not apply (wrong action).]
[Rule "redirect to GEP arranging rule" does not apply (wrong action).]
[Rule "redirect to GEP redrawing rule" does not apply (wrong action).]
[Rule "redirect to GEP sound notification rule" does not apply (wrong action).]
[Rule "redirect to GEP hyperlink rule" does not apply (wrong action).]
[Rule "ordinary checking for content rule" applies.]
[Rule "declare everything initially unmentioned rule" applies.]
[Rule "announce items from multiple object lists rule" applies.]
[Rule "set pronouns from items from multiple object lists rule" applies.]
[Rule "before stage rule" applies.]
[Rule "don't ignore the rating module rule" does not apply (wrong action).]
[Rule "instead stage rule" applies.]
[Rule "investigate player's awareness before action rule" applies.]
[Rule "player aware of his own actions rule" applies.]
[Rule "check stage rule" applies.]
[Rule "carry out stage rule" applies.]
[Rule "after stage rule" applies.]
[Rule "investigate player's awareness after action rule" applies.]
[Rule "report stage rule" applies.]
[Rule "Report giverating" applies.]
YOU ALREADY RATED THIS ASPECT! THANK YOU FOR YOUR COMMITMENT TO THOROUGH CUSTOMER FEEDBACK.
[Rule "last specific action-processing rule" applies.]

[Rule "A first turn sequence rule" applies.]
[Rule "every turn stage rule" applies.]
[Rule "A last turn sequence rule" applies.]
[Rule "notify score changes rule" applies.]

>x button
[Rule "debounce arrange event rule" does not apply (wrong action).]
[Rule "redirect to GEP timed activity rule" does not apply (wrong action).]
[Rule "redirect to GEP character input rule" does not apply (wrong action).]
[Rule "redirect to GEP line input rule" applies.]
[Rule "redirect to GEP mouse input rule" does not apply (wrong action).]
[Rule "redirect to GEP arranging rule" does not apply (wrong action).]
[Rule "redirect to GEP redrawing rule" does not apply (wrong action).]
[Rule "redirect to GEP sound notification rule" does not apply (wrong action).]
[Rule "redirect to GEP hyperlink rule" does not apply (wrong action).]
[Rule "ordinary checking for content rule" applies.]
[Rule "declare everything initially unmentioned rule" applies.]
[Rule "announce items from multiple object lists rule" applies.]
[Rule "set pronouns from items from multiple object lists rule" applies.]
[Rule "before stage rule" applies.]
[Rule "Before examining a thing ( called examinee )" applies.]
THE RATING MODULE IS BACK WITH ANOTHER MESSAGE! ISN'T HE CUTE?

 Please rate the description of the large red button labeled RESUPPLY:

5 - Life changing

4 - Impressive

3 - Mediocre

2 - Trivial

1 - Disgusting

[Rule "don't ignore the rating module rule" applies.]
YOU'VE GOT TO ANSWER THE RATING MODULE'S QUESTION FIRST! LOOK AT THE POOR LITTLE GUY, ALL HE WANTS TO DO IS HELP!

[Rule "A first turn sequence rule" applies.]
[Rule "every turn stage rule" applies.]
[Rule "A last turn sequence rule" applies.]
[Rule "notify score changes rule" applies.]

>rules off
rate 5 stars

>rate 5 stars
rate 5 stars
THE RATING MODULE RAN AWAY... IT USUALLY LIKES HIDING DOWN BY THE STRING TABLES IN MAIN MEMORY, SO IT'LL PROBABLY BE FINE. IN THE MEANTIME, HOLD OFF ON RATING ANYTHING.

* * *

[Rule "redirect to GEP line input rule" applies.]
[Rule "ordinary checking for content rule" applies.]
I beg your pardon?

* * *

>look slot
[Rule "redirect to GEP line input rule" applies.]
[Rule "ordinary checking for content rule" applies.]
[Rule "declare everything initially unmentioned rule" applies.]
[Rule "announce items from multiple object lists rule" applies.]
[Rule "set pronouns from items from multiple object lists rule" applies.]
[Rule "before stage rule" applies.]
[Rule "can't act in the dark rule" applies.]
[Rule "instead stage rule" applies.]
[Rule "investigate player's awareness before action rule" applies.]
[Rule "player aware of his own actions rule" applies.]
[Rule "check stage rule" applies.]
[Rule "carry out stage rule" applies.]
[Rule "standard examining rule" applies.]
[Rule "examine directions rule" applies.]
[Rule "examine containers rule" applies.]
Slot 1 is empty.

[Rule "examine supporters rule" applies.]
[Rule "examine devices rule" applies.]
[Rule "examine undescribed things rule" applies.]
[Rule "after stage rule" applies.]
[Rule "investigate player's awareness after action rule" applies.]
[Rule "report stage rule" applies.]
[Rule "report other people examining rule" applies.]
[Rule "last specific action-processing rule" applies.]
[Rule "A first turn sequence rule" applies.]
[Rule "every turn stage rule" applies.]
[Rule "A last turn sequence rule" applies.]
[Rule "notify score changes rule" applies.]

* * *

 

 

Supply Room
You are standing in a spacious room made of reinforced concrete. A lighting panel illuminates the room in a tense white glow. There is another room to the SOUTH.

An alcove is carved into the wall in front of you. Hovering in the alcove are a SHIELD alloy, a BLADE alloy, an ENTROPIC alloy, a MEND alloy and a SPARK alloy.

A large red button labeled RESUPPLY is mounted above the alcove.

>s
Combination Station
WELCOME TO THE QUALIFICATION DETERMINATION SIMULATION COMBINATION STATION! HERE YOU CAN TAKE ALLOYS FROM THE PREVIOUS ROOM AND FORM THEM INTO NEW AND FANCIFUL CREATIONS. WHAT ARE YOU WAITING FOR? LET'S GET CREATIVE!

You are standing in another concrete room. There are exits to the North and South. In the center is a vast machine labeled 'Combinator'. The machine has 3 slots to put alloys in:

Slot 1 is empty.

Slot 2 is empty.

Slot 3 is empty.

You can also see a green button labelled GO and Intern Jim here.

I beg your pardon?

>attack jim
Violence isn't the answer to this one.

* * *

I beg your pardon?

>look
Combination Station

You are standing in another concrete room. There are exits to the North and South. In the center is a vast machine labeled 'Combinator'. The machine has 3 slots to put elements in:

Slot 1 is empty.

Slot 2 is empty.

Slot 3 is empty.

You can also see a green button labelled GO and Intern Jim here.

The entity suddenly leaps up and clings to the ceiling. Its face suddenly looks confused and hurt.
.

* * *

I beg your pardon?

>s
Arena
STUDIES HAVE SHOWN THAT CREATIVITY IS BOOSTED BY 57% UPON THE INTRODUCTION OF A HOSTILE ENTITY! THUS, WE HAVE PROVIDED AN ENEMY FOR YOU TO DEFEAT IN THIS ROOM. PRESS THE BUTTON WHEN YOU FEEL YOU ARE READY TO FIGHT IT!

This is another large, barren concrete room. Exits are to the north and south.

There is a hostile entity trapped by a force field on the other half of the room from you.

The entity grins at you. Well, not so much "grin" as "curl back its lips and roll its eyes back into its head."

>attack entity
The entity ripples, as if a giant worm is crawling around just under the surface of its skin.

* * *

>s
Arena
STUDIES HAVE SHOWN THAT CREATIVITY IS BOOSTED BY 57% UPON THE INTRODUCTION OF A HOSTILE ENTITY! THUS, WE HAVE PROVIDED AN ENEMY FOR YOU TO DEFEAT IN THIS ROOM. PRESS THE BUTTON WHEN YOU FEEL YOU ARE READY TO FIGHT IT!

This is another large, barren concrete room. Exits are to the north and south.

There is a hostile entity trapped by a force field on the other half of the room from you.

The entity grins at you. Well, not so much "grin" as "curl back its lips and roll its eyes back into its head."

>look
Arena
 sldkj

There is a twitching cube made of twisted limbs floating in the center of the room.

* * *

>s
Arena
STUDIES HAVE SHOWN THAT CREATIVITY IS BOOSTED BY 57% UPON THE INTRODUCTION OF A HOSTILE ENTITY! THUS, WE HAVE PROVIDED AN ENEMY FOR YOU TO DEFEAT IN THIS ROOM. PRESS THE BUTTON WHEN YOU FEEL YOU ARE READY TO FIGHT IT!

This is another large, barren concrete room. Exits are to the north and south.

There is a hostile entity trapped by a force field on the other half of the room from you.

The entity grins at you. Well, not so much "grin" as "curl back its lips and roll its eyes back into its head."

>s
You can't go that way.

>look
Arena
You can see a hostile entity here.

* * *

>s
Combination Station
WELCOME TO THE QUALIFICATION DETERMINATION SIMULATION COMBINATION STATION! HERE YOU CAN TAKE ALLOYS FROM THE PREVIOUS ROOM AND FORM THEM INTO NEW AND FANCIFUL CREATIONS. WHAT ARE YOU WAITING FOR? LET'S GET CREATIVE!

You are standing in another concrete room. There are exits to the North and South. In the center is a vast machine labeled 'Combinator'. The machine has 3 slots to put alloys in:

Slot 1 is empty.

Slot 2 is empty.

Slot 3 is empty.

You can also see a green button labelled GO and Intern Jim here.

>ask jim about ai
"You want to know about the Creativitrix? Well, it's simple. As you can probably tell, AI these is really good at computing and simulating, but is terrible at coming up with original ideas! I mean, the name of this thing is just CREATIVITY plus MATRIX for crying out loud. If you're creative enough, you can sign up as an Endpoint and help come up with original ideas for the AI.

>kick the intern
That's not a verb I recognise.

I beg your pardon?

>hit the intern
Violence isn't the answer to this one.

* * *

>s
Combination Station
WELCOME TO THE QUALIFICATION DETERMINATION SIMULATION COMBINATION STATION! HERE YOU CAN TAKE ALLOYS FROM THE PREVIOUS ROOM AND FORM THEM INTO NEW AND FANCIFUL CREATIONS. WHAT ARE YOU WAITING FOR? LET'S GET CREATIVE!

You are standing in another concrete room. There are exits to the North and South. In the center is a vast machine labeled 'Combinator'. The machine has 3 slots to put alloys in:

Slot 1 is empty.

Slot 2 is empty.

Slot 3 is empty.

You can also see a green button labelled GO and Intern Jim here.

>ask jim about butts
Jim gets a faraway expression on his face. "Yeah... how about them butts."

>ask jim about entropy
Jim nods politely, but clearly doesn't have any idea what you're talking about.

>ask jim about dark
Jim nods politely, but clearly doesn't have any idea what you're talking about.

>ask jim about ai
Jim nods politely, but clearly doesn't have any idea what you're talking about.

>ask jim about me
"You're an applicant for Creativitrix! Keep pumping out creativity and you'll be an endpoint in no time."

* * *

>ask jim about butts
Jim gets a faraway expression on his face. "Yeah... how about them butts."

>ask jim about them butts
Jim nods politely, but clearly doesn't have any idea what you're talking about.

>ask jim about butts butts
Jim nods politely, but clearly doesn't have any idea what you're talking about.

>ask jim about ai
Jim nods politely, but clearly doesn't have any idea what you're talking about.

* * *

>s
Combination Station
WELCOME TO THE QUALIFICATION DETERMINATION SIMULATION COMBINATION STATION! HERE YOU CAN TAKE ALLOYS FROM THE PREVIOUS ROOM AND FORM THEM INTO NEW AND FANCIFUL CREATIONS. WHAT ARE YOU WAITING FOR? LET'S GET CREATIVE!

You are standing in another concrete room. There are exits to the North and South. In the center is a vast machine labeled 'Combinator'. The machine has 3 slots to put alloys in:

Slot 1 is empty.

Slot 2 is empty.

Slot 3 is empty.

You can also see a green button labelled GO and Intern Jim here.

>ask jim about dark
Jim looks uncomfortable. "Entropy... They say that even writing about it or storing information is a vector for it to infect you. All we know is that Entropy has destroyed a lot of civilization. We don't know where it is, what it is, what it wants, or anything... It's even dangerous just to have this Entropy in the simulation."

>ask jim about points
Jim nods politely, but clearly doesn't have any idea what you're talking about.

* * *

>s
Combination Station
WELCOME TO THE QUALIFICATION DETERMINATION SIMULATION COMBINATION STATION! HERE YOU CAN TAKE ALLOYS FROM THE PREVIOUS ROOM AND FORM THEM INTO NEW AND FANCIFUL CREATIONS. WHAT ARE YOU WAITING FOR? LET'S GET CREATIVE!

You are standing in another concrete room. There are exits to the North and South. In the center is a vast machine labeled 'Combinator'. The machine has 3 slots to put alloys in:

Slot 1 is empty.

Slot 2 is empty.

Slot 3 is empty.

You can also see a green button labelled GO and Intern Jim here.

>ask jim about entropy
Jim nods politely, but clearly doesn't have any idea what you're talking about.

* * *

>s
Combination Station
WELCOME TO THE QUALIFICATION DETERMINATION SIMULATION COMBINATION STATION! HERE YOU CAN TAKE ALLOYS FROM THE PREVIOUS ROOM AND FORM THEM INTO NEW AND FANCIFUL CREATIONS. WHAT ARE YOU WAITING FOR? LET'S GET CREATIVE!

You are standing in another concrete room. There are exits to the North and South. In the center is a vast machine labeled 'Combinator'. The machine has 3 slots to put alloys in:

Slot 1 is empty.

Slot 2 is empty.

Slot 3 is empty.

You can also see a green button labelled GO and Intern Jim here.

>ask jim about jim
"Oh, I'm just an Artificially Intelligent intern. Feel free to order me around, test weapons on me..." He notices your confused expression. "I'll regenerate if you do any real harm. Fire away!"

* * *

>s
Combination Station
WELCOME TO THE QUALIFICATION DETERMINATION SIMULATION COMBINATION STATION! HERE YOU CAN TAKE ALLOYS FROM THE PREVIOUS ROOM AND FORM THEM INTO NEW AND FANCIFUL CREATIONS. WHAT ARE YOU WAITING FOR? LET'S GET CREATIVE!

You are standing in another concrete room. There are exits to the North and South. In the center is a vast machine labeled 'Combinator'. The machine has 3 slots to put alloys in:

Slot 1 is empty.

Slot 2 is empty.

Slot 3 is empty.

You can also see a green button labelled GO and Intern Jim here.

>attack intern jim
You attack Intern Jim, causing 8 points of damage!

Intern Jim expires, and is immediately carried away by the Arena slaves!

>s
Arena
STUDIES HAVE SHOWN THAT CREATIVITY IS BOOSTED BY 57% UPON THE INTRODUCTION OF A HOSTILE ENTITY! THUS, WE HAVE PROVIDED AN ENEMY FOR YOU TO DEFEAT IN THIS ROOM. PRESS THE BUTTON WHEN YOU FEEL YOU ARE READY TO FIGHT IT!

This is another large, barren concrete room. Exits are to the north and south.

There is a hostile entity trapped by a force field on the other half of the room from you.

The entity grins at you. Well, not so much "grin" as "curl back its lips and roll its eyes back into its head."
.

>attack intern jim
You can't see any such thing.

>attack entity
You attack the hostile entity, causing 6 points of damage!

The hostile entity attacks you, causing 9 points of damage!

The entity ripples, as if a giant worm is crawling around just under the surface of its skin.
.

>attack entity
You attack the hostile entity, causing 6 points of damage!

The hostile entity attacks you, causing 9 points of damage!

The entity gurgles softly to itself, and jams a finger into its own eye.
.

>attack entity
You attack the hostile entity, causing 5 points of damage!

The hostile entity attacks you, causing 5 points of damage!

The entity stares at you. You feel a dull ache in the base of your spine.
.

>attack entity
You attack the hostile entity, causing 7 points of damage!

The hostile entity attacks you, causing 5 points of damage!

The entity sucks in air, its ribcabe jutting out as its torso compresses into an impossible skinniness.
.

>attack entity
You attack the hostile entity, causing 5 points of damage!

The hostile entity attacks you, causing 4 points of damage!

The entity suddenly leaps up and clings to the ceiling. Its face changes to an expression of confusion.
.

>attack entity
You attack the hostile entity, causing 5 points of damage!

The hostile entity attacks you, causing 9 points of damage!

The entity's skin bubbles.
.

* * *

>s
Arena
STUDIES HAVE SHOWN THAT CREATIVITY IS BOOSTED BY 57% UPON THE INTRODUCTION OF A HOSTILE ENTITY! THUS, WE HAVE PROVIDED AN ENEMY FOR YOU TO DEFEAT IN THIS ROOM. PRESS THE BUTTON WHEN YOU FEEL YOU ARE READY TO FIGHT IT!

This is another large, barren concrete room. Exits are to the north and south.

There is a hostile entity trapped by a force field on the other half of the room from you.

The entity grins at you. Well, not so much "grin" as "curl back its lips and roll its eyes back into its head."

* * *

>s
Combination Station
WELCOME TO THE QUALIFICATION DETERMINATION SIMULATION COMBINATION STATION! HERE YOU CAN TAKE ALLOYS FROM THE PREVIOUS ROOM AND FORM THEM INTO NEW AND FANCIFUL CREATIONS. WHAT ARE YOU WAITING FOR? LET'S GET CREATIVE!

You are standing in another concrete room. There are exits to the North and South. In the center is a vast machine labeled 'Combinator'. The machine has 3 slots to put alloys in:

Slot 1 is empty.

Slot 2 is empty.

Slot 3 is empty.

You can also see a green button labelled GO and Intern Jim here.

>eat slot
Which do you mean, slot 1, slot 2 or slot 3?

>eat slot 1
You slobber on the slots a little. Tastes slotty.

EXCELLENT! BE SURE TO INSPECT YOUR ENVIRONMENT CAREFULLY!

[Your score has just gone up by five points.]

>eat slot 1
You slobber on the slots a little. Tastes slotty.

>eat slot 2
rate 5 stars
THANK YOU FOR YOUR FEEDBACK!

* * *

>s
Combination Station
WELCOME TO THE QUALIFICATION DETERMINATION SIMULATION COMBINATION STATION! HERE YOU CAN TAKE ALLOYS FROM THE PREVIOUS ROOM AND FORM THEM INTO NEW AND FANCIFUL CREATIONS. WHAT ARE YOU WAITING FOR? LET'S GET CREATIVE!

You are standing in another concrete room. There are exits to the North and South. In the center is a vast machine labeled 'Combinator'. The machine has 3 slots to put alloys in:

Slot 1 is empty.

Slot 2 is empty.

Slot 3 is empty.

You can also see a green button labelled GO and Intern Jim here.

>jim, attack jim
Jim smacks himself in the face. Good boy.
EXCELLENT! TEST THE BOUNDS OF WHAT PEOPLE WILL DO FOR YOU!

[Your score has just gone up by twenty points.]

>jump
EXCERSIZING REGULARLY IS KEY TO CREATIVITY! KEEP IT UP!

>jump
EXCERSIZING REGULARLY IS KEY TO CREATIVITY! KEEP IT UP!

>yell
THAT'S IT! GET THOSE CREATIVE JUICES FLOWING!

>shout
THAT'S IT! GET THOSE CREATIVE JUICES FLOWING!

>sniff jim
EXCELLENT! BE SURE TO INSPECT YOUR ENVIRONMENT CAREFULLY!

[Your score has just gone up by five points.]

>eat jm
You can't see any such thing.

>eat jim
You and Jim share a passionate kiss. He cradles the back of your head with his hand and whispers something to you. The hairs on the back of your neck stand up.

EXCELLENT! BE SURE TO INSPECT YOUR ENVIRONMENT CAREFULLY!

[Your score has just gone up by five points.]

>jim, hit jim
Jim smacks himself in the face. Good boy.

>jim, jump
Intern Jim jumps on the spot.

>jim, good boy
There is no reply.

* * *

>s
Combination Station
WELCOME TO THE QUALIFICATION DETERMINATION SIMULATION COMBINATION STATION! HERE YOU CAN TAKE ALLOYS FROM THE PREVIOUS ROOM AND FORM THEM INTO NEW AND FANCIFUL CREATIONS. WHAT ARE YOU WAITING FOR? LET'S GET CREATIVE!

You are standing in another concrete room. There are exits to the North and South. In the center is a vast machine labeled 'Combinator'. The machine has 3 slots to put alloys in:

Slot 1 is empty.

Slot 2 is empty.

Slot 3 is empty.

You can also see a green button labelled GO and Intern Jim here.

>jim, attack me
AMAZING! USING JIM TO TEST YOUR COMBAT ABILITIES IS A FANTASTIC IDEA.

* * *

>n
Supply Room
You are standing in a spacious room made of reinforced concrete. A lighting panel illuminates the room in a tense white glow. There is another room to the south.

An alcove is carved into the wall in front of you. Hovering in the alcove are a SHIELD alloy, a BLADE alloy, an ENTROPIC alloy, a MEND alloy and a SPARK alloy.

A large red button labeled RESUPPLY is mounted above the alcove.

>take mend, spark and shield
MEND alloy: Taken.
SPARK alloy: Taken.
SHIELD alloy: Taken.

>s
Combination Station

You are standing in another concrete room. There are exits to the North and South. In the center is a vast machine labeled 'Combinator'. The machine has 3 slots to put alloys in:

Slot 1 is empty.

Slot 2 is empty.

Slot 3 is empty.

You can also see a green button labelled GO and Intern Jim here.

>combine
Combination Station

You are standing in another concrete room. There are exits to the North and South. In the center is a vast machine labeled 'Combinator'. The machine has 3 slots to put alloys in:

Slot 1 is empty.

Slot 2 is empty.

Slot 3 is empty.

You can also see a green button labelled GO and Intern Jim here.

You walk to the Combination Station.

You put the SHIELD alloy into slot 1.

Slot 1 is full, so let's put MEND alloy in slot 2. You put the MEND alloy into slot 2.

Slot 1 is full, so let's put SPARK alloy in slot 2. Slot 2 is full, so let's put SPARK alloy in slot 3. You put the SPARK alloy into slot 3.

>press go
Ingredient list: MEND alloy, SHIELD alloy and SPARK alloy

The SHIELD and MELD alloys combine to form a magical helmet, and the SPARK alloy makes itself busy by creating a system that diagnoses and heals your wounds. Neat!

AMAZING! THAT'S AN INCREDIBLE HEALING HELMET YOU'VE JUST CREATED! I'M AWARDING YOU 20 CREATIVITY POINTS FOR IT.

You now carry a brand-new healing helmet.

[Your score has just gone up by twenty points.]

* * *

>jim, attack me
AMAZING! USING JIM TO TEST YOUR COMBAT ABILITIES IS A FANTASTIC IDEA.

>rules all
Rules tracing now switched to "all". Type "rules off" to switch it off again.

>jim, attack me
[Rule "debounce arrange event rule" does not apply (wrong action).]
[Rule "redirect to GEP timed activity rule" does not apply (wrong action).]
[Rule "redirect to GEP character input rule" does not apply (wrong action).]
[Rule "redirect to GEP line input rule" applies.]
[Rule "redirect to GEP mouse input rule" does not apply (wrong action).]
[Rule "redirect to GEP arranging rule" does not apply (wrong action).]
[Rule "redirect to GEP redrawing rule" does not apply (wrong action).]
[Rule "redirect to GEP sound notification rule" does not apply (wrong action).]
[Rule "redirect to GEP hyperlink rule" does not apply (wrong action).]
[Rule "ordinary checking for content rule" applies.]
[Rule "After reading a command" applies.]
[Rule "declare everything initially unmentioned rule" applies.]
[Rule "announce items from multiple object lists rule" applies.]
[Rule "set pronouns from items from multiple object lists rule" applies.]
[Rule "before stage rule" applies.]
[Rule "don't ignore the rating module rule" does not apply (wrong action).]
[Rule "instead stage rule" applies.]
[Rule "Persuasion rule for asking Jim to try doing something" applies.]
[Rule "announce items from multiple object lists rule" applies.]
[Rule "set pronouns from items from multiple object lists rule" applies.]
[Rule "before stage rule" applies.]
[Rule "don't ignore the rating module rule" does not apply (wrong action).]
[Rule "instead stage rule" applies.]
[Rule "investigate player's awareness before action rule" applies.]
[Rule "player aware of his own actions rule" applies.]
[Rule "player aware of actions by visible actors rule" applies.]
[Rule "check stage rule" applies.]
[Rule "carry out stage rule" applies.]
[Rule "Carry out suicide" does not apply (wrong actor).]
[Rule "after stage rule" applies.]
[Rule "investigate player's awareness after action rule" applies.]
[Rule "report stage rule" applies.]
[Rule "last specific action-processing rule" applies.]
[Rule "A first turn sequence rule" applies.]
[Rule "every turn stage rule" applies.]
[Rule "Every turn when the entity is not cubed and location is Arena" does not apply (wrong context).]
[Rule "Every turn when the entity is cubed and the location is the Arena" does not apply (wrong context).]
[Rule "A last turn sequence rule" applies.]
[Rule "notify score changes rule" applies.]

* * *

>s
Combination Station
WELCOME TO THE QUALIFICATION DETERMINATION SIMULATION COMBINATION STATION! HERE YOU CAN TAKE ALLOYS FROM THE PREVIOUS ROOM AND FORM THEM INTO NEW AND FANCIFUL CREATIONS. WHAT ARE YOU WAITING FOR? LET'S GET CREATIVE!

You are standing in another concrete room. There are exits to the North and South. In the center is a vast machine labeled 'Combinator'. The machine has 3 slots to put alloys in:

Slot 1 is empty.

Slot 2 is empty.

Slot 3 is empty.

You can also see a green button labelled GO and Intern Jim here.

>jim, attack slot 1
Jim kicks slot 1 as hard as he can. THUNK.

>jim, kill jim
Jim smacks himself in the face. Good boy.
EXCELLENT! TEST THE BOUNDS OF WHAT PEOPLE WILL DO FOR YOU!

[Your score has just gone up by twenty points.]

>jim, kill jim
Jim smacks himself in the face. Good boy.
EXCELLENT! TEST THE BOUNDS OF WHAT PEOPLE WILL DO FOR YOU!

[Your score has just gone up by twenty points.]

* * *

>s
Combination Station
WELCOME TO THE QUALIFICATION DETERMINATION SIMULATION COMBINATION STATION! HERE YOU CAN TAKE ALLOYS FROM THE PREVIOUS ROOM AND FORM THEM INTO NEW AND FANCIFUL CREATIONS. WHAT ARE YOU WAITING FOR? LET'S GET CREATIVE!

You are standing in another concrete room. There are exits to the North and South. In the center is a vast machine labeled 'Combinator'. The machine has 3 slots to put alloys in:

Slot 1 is empty.

Slot 2 is empty.

Slot 3 is empty.

You can also see a green button labelled GO and Intern Jim here.

>jim, eta me
There is no reply.

>jim, eat me
Jim looks a little confused. He didn't fully understand that command.

>n
Supply Room
You are standing in a spacious room made of reinforced concrete. A lighting panel illuminates the room in a tense white glow. There is another room to the south.

An alcove is carved into the wall in front of you. Hovering in the alcove are a SHIELD alloy, a BLADE alloy, an ENTROPIC alloy, a MEND alloy and a SPARK alloy.

A large red button labeled RESUPPLY is mounted above the alcove.

>tak emend
That's not a verb I recognise.

>take mend
Taken.

>s
Combination Station

You are standing in another concrete room. There are exits to the North and South. In the center is a vast machine labeled 'Combinator'. The machine has 3 slots to put alloys in:

Slot 1 is empty.

Slot 2 is empty.

Slot 3 is empty.

You can also see a green button labelled GO and Intern Jim here.

>jim, eat mend
Jim looks a little confused. He didn't fully understand that command.

>give mend to jim
Intern Jim doesn't seem interested.

* * *

>s
Combination Station
WELCOME TO THE QUALIFICATION DETERMINATION SIMULATION COMBINATION STATION! HERE YOU CAN TAKE ALLOYS FROM THE PREVIOUS ROOM AND FORM THEM INTO NEW AND FANCIFUL CREATIONS. WHAT ARE YOU WAITING FOR? LET'S GET CREATIVE!

You are standing in another concrete room. There are exits to the North and South. In the center is a vast machine labeled 'Combinator'. The machine has 3 slots to put alloys in:

Slot 1 is empty.

Slot 2 is empty.

Slot 3 is empty.

You can also see a green button labelled GO and Intern Jim here.

>jim, jump
Intern Jim jumps on the spot.

* * *

>jim, go n
Intern Jim goes north.

>n
Supply Room
You are standing in a spacious room made of reinforced concrete. A lighting panel illuminates the room in a tense white glow. There is another room to the south.

An alcove is carved into the wall in front of you. Hovering in the alcove are a SHIELD alloy, a BLADE alloy, an ENTROPIC alloy, a MEND alloy and a SPARK alloy.

A large red button labeled RESUPPLY is mounted above the alcove.

You can also see Intern Jim here.

* * *

>jim, weoifj
There is no reply.

>jim, take all
alcove: Intern Jim is unable to do that.

large red button labeled RESUPPLY: Intern Jim is unable to do that.

Intern Jim: Intern Jim is unable to do that.

HOW DID YOU FIND ME >_> GO AWAY: Intern Jim is unable to do that.

passage: Intern Jim is unable to do that.

concrete: Intern Jim is unable to do that.

lighting panel: Intern Jim is unable to do that.

>jim, take mend
Intern Jim picks up the MEND alloy.

>jim, go s
Intern Jim goes south.

>s
Combination Station

You are standing in another concrete room. There are exits to the North and South. In the center is a vast machine labeled 'Combinator'. The machine has 3 slots to put elements in:

Slot 1 is empty.

Slot 2 is empty.

Slot 3 is empty.

You can also see Intern Jim and a green button labelled GO here.

>jim, put mend in slot 1
Intern Jim puts the MEND alloy into slot 1.

>jim, go north and take mend
There is no reply.

>jim, go north.jim, take mend.jim, go s
Intern Jim goes north.

You seem to want to talk to someone, but I can't see whom.

>n
Supply Room
You are standing in a spacious room made of reinforced concrete. A lighting panel illuminates the room in a tense white glow. There is another room to the south.

An alcove is carved into the wall in front of you. Hovering in the alcove are a SHIELD alloy, a BLADE alloy, an ENTROPIC alloy and a SPARK alloy.

A large red button labeled RESUPPLY is mounted above the alcove.

You can also see Intern Jim here.

>jim, go s
Intern Jim goes south.

>n
You can't go that way.

>s
Combination Station

You are standing in another concrete room. There are exits to the North and South. In the center is a vast machine labeled 'Combinator'. The machine has 3 slots to put elements in:

Slot 1 contains a MEND alloy.

Slot 2 is empty.

Slot 3 is empty.

You can also see Intern Jim and a green button labelled GO here.

>jim, put mend in slot 1 and press go
There is no reply.

>jim, put mend in slot 1. jim, press go
(Intern Jim first taking the MEND alloy)
Intern Jim puts the MEND alloy into slot 1.

There is no reply.

* * *

>press button
There are 2 slots that don't have an alloy in them! Please put another alloy in before you press GO.

* * *

>s
Combination Station
WELCOME TO THE QUALIFICATION DETERMINATION SIMULATION COMBINATION STATION! HERE YOU CAN TAKE ALLOYS FROM THE PREVIOUS ROOM AND FORM THEM INTO NEW AND FANCIFUL CREATIONS. WHAT ARE YOU WAITING FOR? LET'S GET CREATIVE!

You are standing in another concrete room. There are exits to the North and South. In the center is a vast machine labeled 'Combinator'. The machine has 3 slots to put alloys in:

Slot 1 is empty.

Slot 2 is empty.

Slot 3 is empty.

You can also see a green button labelled GO and Intern Jim here.

>n
Supply Room
You are standing in a spacious room made of reinforced concrete. A lighting panel illuminates the room in a tense white glow. There is another room to the south.

An alcove is carved into the wall in front of you. Hovering in the alcove are a SHIELD alloy, a BLADE alloy, an ENTROPIC alloy, a MEND alloy and a SPARK alloy.

A large red button labeled RESUPPLY is mounted above the alcove.

>abstract healing helmet to me
[Abstracted.]

>wear healing helmet
YUM.

You put on the healing helmet.

* * *

>n
Supply Room
You are standing in a spacious room made of reinforced concrete. A lighting panel illuminates the room in a tense white glow. There is another room to the south.

An alcove is carved into the wall in front of you. Hovering in the alcove are a SHIELD alloy, a BLADE alloy, an ENTROPIC alloy, a MEND alloy and a SPARK alloy.

A large red button labeled RESUPPLY is mounted above the alcove.

>take mend
Test this
Taken.

I beg your pardon?

>s
Combination Station
You are standing in another concrete room. In the center is a vast machine labeled 'Combinator'.

There are exits to the North and South.

You can see Slot 1 here.

>put mend in slot
That can't contain things.

>put mend in Slot 1
That can't contain things.

* * *

>take mend
Test this
Taken.

>s
Combination Station

You are standing in another concrete room. There are exits to the North and South. In the center is a vast machine labeled 'Combinator'. The machine has 3 slots to put elements in:

Slot 1 is empty

>put mend in slot 1
You put the MEND alloy into slot 1.

>look
Combination Station

You are standing in another concrete room. There are exits to the North and South. In the center is a vast machine labeled 'Combinator'. The machine has 3 slots to put elements in:

Slot 1 is contains something.

* * *

>n
Supply Room
You are standing in a spacious room made of reinforced concrete. A lighting panel illuminates the room in a tense white glow. There is another room to the south.

An alcove is carved into the wall in front of you. Hovering in the alcove are a SHIELD alloy, a BLADE alloy, an ENTROPIC alloy, a MEND alloy and a SPARK alloy.

A large red button labeled RESUPPLY is mounted above the alcove.

>z
Time passes.

>z
rate 5 stars
THANK YOU FOR YOUR FEEDBACK!

>x button
A glowing red button. PRESS THIS BUTTON IF YOU NEED MORE ALLOYS.

THE RATING MODULE IS BACK WITH ANOTHER MESSAGE! ISN'T HE CUTE?:

 Please rate the description of the large red button labeled RESUPPLY:

5 - Life changing

4 - Impressive

3 - Mediocre

2 - Trivial

1 - Disgusting

>s
Combination Station

You are standing in another concrete room. There are exits to the North and South. In the center is a vast machine labeled 'Combinator'. The machine has 3 slots to put elements in:

Slot 1 contains nothing.

Slot 2 contains nothing.

Slot 3 contains nothing.

>n
Supply Room
You are standing in a spacious room made of reinforced concrete. A lighting panel illuminates the room in a tense white glow. There is another room to the south.

An alcove is carved into the wall in front of you. Hovering in the alcove are a SHIELD alloy, a BLADE alloy, an ENTROPIC alloy, a MEND alloy and a SPARK alloy.

A large red button labeled RESUPPLY is mounted above the alcove.

>rules
Rules tracing now switched on. Type "rules off" to switch it off again, or "rules all" to include even rules which do not apply.

* * *

>s
Combination Station
WELCOME TO THE QUALIFICATION DETERMINATION SIMULATION COMBINATION STATION! HERE YOU CAN TAKE ALLOYS FROM THE PREVIOUS ROOM AND FORM THEM INTO NEW AND FANCIFUL CREATIONS. WHAT ARE YOU WAITING FOR? LET'S GET CREATIVE!

You are standing in another concrete room. There are exits to the North and South. In the center is a vast machine labeled 'Combinator'. The machine has 3 slots to put alloys in:

Slot 1 is empty.

Slot 2 is empty.

Slot 3 is empty.

You can also see a green button labelled GO and Intern Jim here.

>press button
HERE WE GO

* * *

>s
Arena
STUDIES HAVE SHOWN THAT CREATIVITY IS BOOSTED BY 57% UPON THE INTRODUCTION OF A HOSTILE ENTITY! THUS, WE HAVE PROVIDED AN ENEMY FOR YOU TO DEFEAT IN THIS ROOM. PRESS THE BUTTON WHEN YOU FEEL YOU ARE READY TO FIGHT IT!

This is another large, barren concrete room. Exits are to the north and south.

There is a hostile entity trapped by a force field on the other half of the room from you.

The entity grins at you. Well, not so much "grin" as "curl back its lips and roll its eyes back into its head."

I beg your pardon?

>smell invisible
Smells like ozone.

EXCELLENT! BE SURE TO INSPECT YOUR ENVIRONMENT CAREFULLY!

The entity sucks in air, its ribcabe jutting out as its torso compresses into an impossible skinniness.
.

[Your score has just gone up by five points.]

>touch barrier
You place your hand against the field. It feels like hardened air - you don't feel anything solid against your hand but it won't move any further than the very middle of the room.

EXCELLENT! BE SURE TO INSPECT YOUR ENVIRONMENT CAREFULLY!

The entity gurgles softly to itself, and jams a finger into its own eye.
.

[Your score has just gone up by five points.]

>eat barrier
It feels like you're licking hardened air.

EXCELLENT! BE SURE TO INSPECT YOUR ENVIRONMENT CAREFULLY!

The entity suddenly leaps up and clings to the ceiling. Its face changes to an expression of confusion.
.

[Your score has just gone up by five points.]

>look entity
There is a naked, flesh-colored humanoid thing across the room from you. It seems to be bounded to its half of the room by an invisible force field.

I ADMIRE YOUR INQUISITIVE NATURE!

The entity ripples, as if a giant worm is crawling around just under the surface of its skin.
.

[Your score has just gone up by five points.]

* * *

>s
Arena
STUDIES HAVE SHOWN THAT CREATIVITY IS BOOSTED BY 57% UPON THE INTRODUCTION OF A HOSTILE ENTITY! THUS, WE HAVE PROVIDED AN ENEMY FOR YOU TO DEFEAT IN THIS ROOM. PRESS THE BUTTON WHEN YOU FEEL YOU ARE READY TO FIGHT IT!

This is another large, barren concrete room. Exits are to the north and south.

There is a hostile entity trapped by a force field on the other half of the room from you.

The entity grins at you. Well, not so much "grin" as "curl back its lips and roll its eyes back into its head."

>abstract syringe to me
[Abstracted.]

>press button
Suddenly, blue waves ripple across the air in the center of the room, revealing the barrier. It dissolves with a final shimmer.

The entity makes a guttural clicking sound and scuttles across the floor towards you!

time to attack
The entity attacks you, causing 5 - 0 points of damage!

>use syringe
You plunge the healing syringe into your arm. The MEND alloy courses through you, healing your wounds, and the SHIELD alloy creates a tough barrier around your skin!

time to attack
The entity attacks you, causing 9 points of damage!

>attack entity
You attack the hostile entity, causing 6 points of damage!

time to attack
The entity attacks you, causing 9 points of damage!

>attack entity
You attack the hostile entity, causing 5 points of damage!

time to attack
The entity attacks you, causing 3 points of damage!

>atack entity
That's not a verb I recognise.

>attack entity
You attack the hostile entity, causing 7 points of damage!

time to attack
The entity attacks you, causing 3 points of damage!

>attack entity
You attack the hostile entity, causing 6 points of damage!

time to attack
The entity attacks you, causing 2 points of damage!

* * *

>press button
Suddenly, blue waves ripple across the air in the center of the room, revealing the barrier. It dissolves with a final shimmer.

The entity makes a guttural clicking sound and scuttles across the floor towards you!

time to attack
The entity attacks you, causing 5 - 0 points of damage!

>z
Time passes.

time to attack
The entity attacks you, causing 9 - 0 points of damage!

>use syringe
You plunge the healing syringe into your arm. The MEND alloy courses through you, healing your wounds!
The SHIELD alloy creates a tough barrier around your skin!

time to attack
The entity attacks you, causing 7 - 3 points of damage!

>z
Time passes.

time to attack
The entity attacks you, causing 7 - 3 points of damage!

>z
Time passes.

time to attack
The entity attacks you, causing -1 - 3 points of damage!

>z
Time passes.

time to attack
The entity attacks you, causing 2 - 3 points of damage!

>z
Time passes.

time to attack
The entity attacks you, causing 7 - 3 points of damage!

>z
Time passes.

time to attack
The entity attacks you, causing 5 - 3 points of damage!

>z
Time passes.

time to attack
The entity attacks you, causing 1 - 3 points of damage!

>z
Time passes.

time to attack
The entity attacks you, causing 0 - 3 points of damage!

>z
Time passes.

time to attack
The entity attacks you, causing 7 - 3 points of damage!

>z
Time passes.

time to attack
The entity attacks you, causing 0 - 3 points of damage!

>n
Combination Station

You are standing in another concrete room. There are exits to the North and South. In the center is a vast machine labeled 'Combinator'. The machine has 3 slots to put alloys in:

Slot 1 is empty.

Slot 2 is empty.

Slot 3 is empty.

You can also see a green button labelled GO and Intern Jim here.

>n
Supply Room
You are standing in a spacious room made of reinforced concrete. A lighting panel illuminates the room in a tense white glow. There is another room to the south.

An alcove is carved into the wall in front of you. Hovering in the alcove are a SHIELD alloy, a BLADE alloy, an ENTROPIC alloy, a MEND alloy and a SPARK alloy.

A large red button labeled RESUPPLY is mounted above the alcove.

>sniff wall
You sniff the concrete. You think someone once told you this is how you get "stoned."

EXCELLENT! BE SURE TO INSPECT YOUR ENVIRONMENT CAREFULLY!

[Your score has just gone up by five points.]

>sniff wall
You sniff the concrete. You think someone once told you this is how you get "stoned."

>attack light
You've always fantasized about fighting a light. But it doesn't feel right, because fighting the light might leave you in night.

* * *

>s
Arena
STUDIES HAVE SHOWN THAT CREATIVITY IS BOOSTED BY 57% UPON THE INTRODUCTION OF A HOSTILE ENTITY! THUS, WE HAVE PROVIDED AN ENEMY FOR YOU TO DEFEAT IN THIS ROOM. PRESS THE BUTTON WHEN YOU FEEL YOU ARE READY TO FIGHT IT!

This is another large, barren concrete room. Exits are to the north and south.

There is a hostile entity trapped by a force field on the other half of the room from you.

The entity grins at you. Well, not so much "grin" as "curl back its lips and roll its eyes back into its head."

>attack entity
You attack the hostile entity, causing 5 points of damage!

The hostile entity attacks you, causing 4 points of damage!

The entity ripples, as if a giant worm is crawling around just under the surface of its skin.

>rules all
Rules tracing now switched to "all". Type "rules off" to switch it off again.

>attack entity
[Rule "debounce arrange event rule" does not apply (wrong action).]
[Rule "redirect to GEP timed activity rule" does not apply (wrong action).]
[Rule "redirect to GEP character input rule" does not apply (wrong action).]
[Rule "redirect to GEP line input rule" applies.]
[Rule "redirect to GEP mouse input rule" does not apply (wrong action).]
[Rule "redirect to GEP arranging rule" does not apply (wrong action).]
[Rule "redirect to GEP redrawing rule" does not apply (wrong action).]
[Rule "redirect to GEP sound notification rule" does not apply (wrong action).]
[Rule "redirect to GEP hyperlink rule" does not apply (wrong action).]
[Rule "ordinary checking for content rule" applies.]
[Rule "After reading a command" applies.]
[Rule "declare everything initially unmentioned rule" applies.]
[Rule "announce items from multiple object lists rule" applies.]
[Rule "set pronouns from items from multiple object lists rule" applies.]
[Rule "before stage rule" applies.]
[Rule "don't ignore the rating module rule" applies.]
[Rule "instead stage rule" applies.]
[Rule "fightlight rule" does not apply (wrong action).]
[Rule "Instead of anyone ( called violence_doer ) attacking someone ( called victim )" does not apply (wrong action).]
[Rule "investigate player's awareness before action rule" applies.]
[Rule "player aware of his own actions rule" applies.]
[Rule "check stage rule" applies.]
[Rule "block attacking rule" applies.]
Violence isn't the answer to this one.

[Rule "A first turn sequence rule" applies.]
[Rule "every turn stage rule" applies.]
[Rule "Every turn when the entity is cubed and the location is the Arena" applies.]
The entity gurgles softly to itself, and jams a finger into its own eye.
.

[Rule "A last turn sequence rule" applies.]
[Rule "notify score changes rule" applies.]

* * *

>attack entity
You attack the hostile entity, causing 5 points of damage!

The hostile entity attacks you, causing 4 points of damage!

The entity ripples, as if a giant worm is crawling around just under the surface of its skin.

>z
Time passes.

The entity gurgles softly to itself, and jams a finger into its own eye.

* * *

>s
Arena
STUDIES HAVE SHOWN THAT CREATIVITY IS BOOSTED BY 57% UPON THE INTRODUCTION OF A HOSTILE ENTITY! THUS, WE HAVE PROVIDED AN ENEMY FOR YOU TO DEFEAT IN THIS ROOM. PRESS THE BUTTON WHEN YOU FEEL YOU ARE READY TO FIGHT IT!

This is another large, barren concrete room. Exits are to the north and south.

There is a hostile entity trapped by a force field on the other half of the room from you.

The entity grins at you. Well, not so much "grin" as "curl back its lips and roll its eyes back into its head."

>look
Arena

This is another large, barren concrete room. Exits are to the north and south.

There is a hostile entity trapped by a force field on the other half of the room from you.

The entity stares at you. You feel a dull ache in the base of your spine.
.

>look
Arena

This is another large, barren concrete room. Exits are to the north and south.

There is a hostile entity trapped by a force field on the other half of the room from you.

* * *

>look
Arena

This is another large, barren concrete room. Exits are to the north and south.

There is a hostile entity trapped by a force field on the other half of the room from you.

The entity stares at you. You feel a dull ache in the base of your spine.
.

>look entity
There is a naked, flesh-colored humanoid thing across the room from you. It seems to be bounded to its half of the room by an invisible force field.

I ADMIRE YOUR INQUISITIVE NATURE!

The entity sucks in air, its ribcabe jutting out as its torso compresses into an impossible skinniness.
.

[Your score has just gone up by five points.]

>look field
There seems to be an invisible barrier dividing the room in half. No physical matter can cross it.

I ADMIRE YOUR EXPLORATORY NATURE!

The entity suddenly leaps up and clings to the ceiling. Its face changes to an expression of confusion.
.

[Your score has just gone up by five points.]

>look field
There seems to be an invisible barrier dividing the room in half. No physical matter can cross it.

The entity stares at you. You feel a dull ache in the base of your spine.
.

>touch field
You place your hand against the field. It feels like hardened air - you don't feel anything solid against your hand but it won't move any further than the very middle of the room.

EXCELLENT! BE SURE TO INSPECT YOUR ENVIRONMENT CAREFULLY!

The entity sucks in air, its ribcabe jutting out as its torso compresses into an impossible skinniness.
.

[Your score has just gone up by five points.]

* * *

>s
Arena
STUDIES HAVE SHOWN THAT CREATIVITY IS BOOSTED BY 57% UPON THE INTRODUCTION OF A HOSTILE ENTITY! THUS, WE HAVE PROVIDED AN ENEMY FOR YOU TO DEFEAT IN THIS ROOM. PRESS THE BUTTON WHEN YOU FEEL YOU ARE READY TO FIGHT IT!

This is another large, barren concrete room. Exits are to the north and south.

There is a hostile entity trapped by a force field on the other half of the room from you.

The entity grins at you. Well, not so much "grin" as "curl back its lips and roll its eyes back into its head."

>n
Combination Station

You are standing in another concrete room. There are exits to the North and South. In the center is a vast machine labeled 'Combinator'. The machine has 3 slots to put elements in:

Slot 1 is empty.

Slot 2 is empty.

Slot 3 is empty.

You can also see a green button labelled GO and Intern Jim here.

* * *

>actions
Actions listing on.

>ules all
That's not a verb I recognise.

>rules all
Rules tracing now switched to "all". Type "rules off" to switch it off again.

>jim, hit me
[Rule "debounce arrange event rule" does not apply (wrong action).]
[Rule "redirect to GEP timed activity rule" does not apply (wrong action).]
[Rule "redirect to GEP character input rule" does not apply (wrong action).]
[Rule "redirect to GEP line input rule" applies.]
[Rule "redirect to GEP mouse input rule" does not apply (wrong action).]
[Rule "redirect to GEP arranging rule" does not apply (wrong action).]
[Rule "redirect to GEP redrawing rule" does not apply (wrong action).]
[Rule "redirect to GEP sound notification rule" does not apply (wrong action).]
[Rule "redirect to GEP hyperlink rule" does not apply (wrong action).]
[Rule "ordinary checking for content rule" applies.]
[Rule "After reading a command" applies.]
[Rule "declare everything initially unmentioned rule" applies.]
[asking Intern Jim to try suicide]
[Rule "announce items from multiple object lists rule" applies.]
[Rule "set pronouns from items from multiple object lists rule" applies.]
[Rule "before stage rule" applies.]
[Rule "don't ignore the rating module rule" does not apply (wrong action).]
[Rule "instead stage rule" applies.]
[Rule "Persuasion rule for asking Jim to try doing something" applies.]
[(1) Intern Jim suicide]
[Rule "announce items from multiple object lists rule" applies.]
[Rule "set pronouns from items from multiple object lists rule" applies.]
[Rule "before stage rule" applies.]
[Rule "don't ignore the rating module rule" does not apply (wrong action).]
[Rule "instead stage rule" applies.]
[Rule "investigate player's awareness before action rule" applies.]
[Rule "player aware of his own actions rule" applies.]
[Rule "player aware of actions by visible actors rule" applies.]
[Rule "check stage rule" applies.]
[Rule "carry out stage rule" applies.]
[Rule "Carry out suicide" does not apply (wrong actor).]
[Rule "after stage rule" applies.]
[Rule "investigate player's awareness after action rule" applies.]
[Rule "report stage rule" applies.]
[Rule "last specific action-processing rule" applies.]
[(1) Intern Jim suicide - succeeded]

[asking Intern Jim to try suicide - succeeded]

[Rule "A first turn sequence rule" applies.]
[Rule "every turn stage rule" applies.]
[Rule "Every turn when the entity is not cubed and location is Arena" does not apply (wrong context).]
[Rule "Every turn when the entity is cubed and the location is the Arena" does not apply (wrong context).]
[Rule "A last turn sequence rule" applies.]
[Rule "notify score changes rule" applies.]

* * *

>jim, hit player
There is no reply.

* * *

>rules all
Rules tracing now switched to "all". Type "rules off" to switch it off again.

* * *

>jim, hit me
[Rule "debounce arrange event rule" does not apply (wrong action).]
[Rule "redirect to GEP timed activity rule" does not apply (wrong action).]
[Rule "redirect to GEP character input rule" does not apply (wrong action).]
[Rule "redirect to GEP line input rule" applies.]
[Rule "redirect to GEP mouse input rule" does not apply (wrong action).]
[Rule "redirect to GEP arranging rule" does not apply (wrong action).]
[Rule "redirect to GEP redrawing rule" does not apply (wrong action).]
[Rule "redirect to GEP sound notification rule" does not apply (wrong action).]
[Rule "redirect to GEP hyperlink rule" does not apply (wrong action).]
[Rule "ordinary checking for content rule" applies.]
[Rule "After reading a command" applies.]
[Rule "declare everything initially unmentioned rule" applies.]
[asking Intern Jim to try suicide]
[Rule "announce items from multiple object lists rule" applies.]
[Rule "set pronouns from items from multiple object lists rule" applies.]
[Rule "before stage rule" applies.]
[Rule "don't ignore the rating module rule" does not apply (wrong action).]
[Rule "instead stage rule" applies.]
[Rule "Persuasion rule for asking Jim to try doing something" applies.]
[(1) Intern Jim suicide]
[Rule "announce items from multiple object lists rule" applies.]
[Rule "set pronouns from items from multiple object lists rule" applies.]
[Rule "before stage rule" applies.]
[Rule "don't ignore the rating module rule" does not apply (wrong action).]
[Rule "instead stage rule" applies.]
[Rule "investigate player's awareness before action rule" applies.]
[Rule "player aware of his own actions rule" applies.]
[Rule "player aware of actions by visible actors rule" applies.]
[Rule "check stage rule" applies.]
[Rule "carry out stage rule" applies.]
[Rule "Carry out suicide" does not apply (wrong actor).]
[Rule "after stage rule" applies.]
[Rule "investigate player's awareness after action rule" applies.]
[Rule "report stage rule" applies.]
[Rule "last specific action-processing rule" applies.]
[(1) Intern Jim suicide - succeeded]

[asking Intern Jim to try suicide - succeeded]

[Rule "A first turn sequence rule" applies.]
[Rule "every turn stage rule" applies.]
[Rule "Every turn when the entity is not cubed and location is Arena" does not apply (wrong context).]
[Rule "Every turn when the entity is cubed and the location is the Arena" does not apply (wrong context).]
[Rule "A last turn sequence rule" applies.]
[Rule "notify score changes rule" applies.]

* * *

>n
Combination Station

You are standing in another concrete room. There are exits to the North and South. In the center is a vast machine labeled 'Combinator'. The machine has 3 slots to put elements in:

Slot 1 is empty.

Slot 2 is empty.

Slot 3 is empty.

You can also see a green button labelled GO and Intern Jim here.

>n
rate 5 stars
THANK YOU FOR YOUR FEEDBACK!

>x button
A glowing red button. PRESS THIS BUTTON IF YOU NEED MORE ALLOYS.

THE RATING MODULE IS BACK WITH ANOTHER MESSAGE! ISN'T HE CUTE?:

 Please rate the description of the large red button labeled RESUPPLY:

5 - Life changing

4 - Impressive

3 - Mediocre

2 - Trivial

1 - Disgusting

* * *

>s
Arena
STUDIES HAVE SHOWN THAT CREATIVITY IS BOOSTED BY 57% UPON THE INTRODUCTION OF A HOSTILE ENTITY! THUS, WE HAVE PROVIDED AN ENEMY FOR YOU TO DEFEAT IN THIS ROOM. PRESS THE BUTTON WHEN YOU FEEL YOU ARE READY TO FIGHT IT!

This is another large, barren concrete room. Exits are to the north and south.

There is a hostile entity trapped by a force field on the other half of the room from you.

The entity grins at you. Well, not so much "grin" as "curl back its lips and roll its eyes back into its head."

>press button
Suddenly, blue waves ripple across the air in the center of the room, revealing the barrier. It dissolves with a final shimmer.

The entity makes a guttural clicking sound and scuttles across the floor towards you!

time to attack
The entity attacks you, causing 12 points of damage!

>abstract syringe
(to the hostile entity)
[Abstracted.]

>abstract syringe to me
[Abstracted.]

>use syringe
You plunge the healing syringe into your arm. The MEND alloy courses through you, healing your wounds, and the SHIELD alloy creates a tough barrier around your skin!

time to attack
The entity attacks you, causing 8 - 0 points of damage!

>z
Time passes.

time to attack
The entity attacks you, causing 10 - 0 points of damage!

* * *

>press button
Suddenly, blue waves ripple across the air in the center of the room, revealing the barrier. It dissolves with a final shimmer.

The entity makes a guttural clicking sound and scuttles across the floor towards you!

time to attack
The entity attacks you, causing 12 points of damage!

>attack entity
You attack the hostile entity, causing 7 points of damage!

The hostile entity attacks you, causing 10 points of damage!

time to attack

>n
Combination Station

You are standing in another concrete room. There are exits to the North and South. In the center is a vast machine labeled 'Combinator'. The machine has 3 slots to put elements in:

Slot 1 is empty.

Slot 2 is empty.

Slot 3 is empty.

You can also see a green button labelled GO and Intern Jim here.

time to attack

>n
Supply Room
You are standing in a spacious room made of reinforced concrete. A lighting panel illuminates the room in a tense white glow. There is another room to the south.

An alcove is carved into the wall in front of you. Hovering in the alcove are a SHIELD alloy, a BLADE alloy, an ENTROPIC alloy, a MEND alloy and a SPARK alloy.

A large red button labeled RESUPPLY is mounted above the alcove.

time to attack

>take mend
Taken.

time to attack

>s
Combination Station

You are standing in another concrete room. There are exits to the North and South. In the center is a vast machine labeled 'Combinator'. The machine has 3 slots to put elements in:

Slot 1 is empty.

Slot 2 is empty.

Slot 3 is empty.

You can also see a green button labelled GO and Intern Jim here.

time to attack

>give mend to jim
Intern Jim doesn't seem interested.

time to attack

* * *

>press button
Suddenly, blue waves ripple across the air in the center of the room, revealing the barrier. It dissolves with a final shimmer.

The entity makes a guttural clicking sound and scuttles across the floor towards you!

time to attack
The entity attacks you, causing 12 points of damage!

>z
Time passes.

time to attack
The entity attacks you, causing 16 points of damage!

>z
Time passes.

time to attack
The entity attacks you, causing 17 points of damage!

>z
Time passes.

time to attack
The entity attacks you, causing 19 points of damage!

>z
Time passes.

time to attack
The entity attacks you, causing 13 points of damage!

>z
Time passes.

time to attackThe entity grabs you by both shoulders and unhinges its jaw, releasing a cloud of caustic black smoke. You cough and choke as the black smoke fills you with poison. It feels like your insides are on fire.

You feel the entropic energy course course through your bloodstream, searing your insides!
You take 5 damage.

>z
Time passes.

time to attackThe entity grabs you by both shoulders and unhinges its jaw, releasing a cloud of caustic black smoke. You cough and choke as the black smoke fills you with poison. It feels like your insides are on fire.

You feel the entropic energy course course through your bloodstream, searing your insides!
You take 5 damage.

>z
Time passes.

time to attack
The entity attacks you, causing 19 points of damage!

You feel the entropic energy course course through your bloodstream, searing your insides!
You take 9 damage.

>z
Time passes.

time to attackThe entity grabs you by both shoulders and unhinges its jaw, releasing a cloud of caustic black smoke. You cough and choke as the black smoke fills you with poison. It feels like your insides are on fire.

You feel the entropic energy course course through your bloodstream, searing your insides!
You take 7 damage.

>z
Time passes.

time to attackThe entity grabs you by both shoulders and unhinges its jaw, releasing a cloud of caustic black smoke. You cough and choke as the black smoke fills you with poison. It feels like your insides are on fire.

You feel the entropic energy course course through your bloodstream, searing your insides!
You take 8 damage.

>z
Time passes.

time to attack
The entity attacks you, causing 16 points of damage!

You feel the entropic energy course course through your bloodstream, searing your insides!
You take 7 damage.

>z
Time passes.

time to attack
The entity attacks you, causing 18 points of damage!

You feel the entropic energy course course through your bloodstream, searing your insides!
You take 5 damage.
You shudder as the last of the poison leaves your system.

>z
Time passes.

time to attack
The entity attacks you, causing 17 points of damage!

>z
Time passes.

time to attackThe entity grabs you by both shoulders and unhinges its jaw, releasing a cloud of caustic black smoke. You cough and choke as the black smoke fills you with poison. It feels like your insides are on fire.

You feel the entropic energy course course through your bloodstream, searing your insides!
You take 7 damage.

>z
Time passes.

time to attackThe entity grabs you by both shoulders and unhinges its jaw, releasing a cloud of caustic black smoke. You cough and choke as the black smoke fills you with poison. It feels like your insides are on fire.

You feel the entropic energy course course through your bloodstream, searing your insides!
You take 6 damage.

>z
Time passes.

time to attack
The entity attacks you, causing 20 points of damage!

You fall down dead.

HUMAN! YOU HAVE GOTTEN YOURSELF KILLED! IF YOU CAN'T DEFEAT THE ENTITY, TRY TO MAKE MORE ITEMS IN THE COMBINATOR, AND "USE" THE ITEMS YOU ALREADY HAVE! REMEMBER TO BE CREATIVE!

I'VE RESET YOU BACK TO THE COMBINATION STATION!

Combination Station

You are standing in another concrete room. There are exits to the North and South. In the center is a vast machine labeled 'Combinator'. The machine has 3 slots to put alloys in:

Slot 1 is empty.

Slot 2 is empty.

Slot 3 is empty.

You can also see a green button labelled GO and Intern Jim here.

* * *

>s
Arena
STUDIES HAVE SHOWN THAT CREATIVITY IS BOOSTED BY 57% UPON THE INTRODUCTION OF A HOSTILE ENTITY! THUS, WE HAVE PROVIDED AN ENEMY FOR YOU TO DEFEAT IN THIS ROOM. PRESS THE BUTTON WHEN YOU FEEL YOU ARE READY TO FIGHT IT!

This is another large, barren concrete room. Exits are to the north and south.

There is a hostile entity trapped by a force field on the other half of the room from you.

The entity grins at you. Well, not so much "grin" as "curl back its lips and roll its eyes back into its head."

>s
You can't go that way.

The entity ripples, as if a giant worm is crawling around just under the surface of its skin.

>look
Arena

This is another large, barren concrete room. Exits are to the north and south.

There is a hostile entity trapped by a force field on the other half of the room from you.

The entity stares at you. You feel a dull ache in the base of your spine.
.

>look
Arena

This is another large, barren concrete room. Exits are to the north and south.

There is a hostile entity trapped by a force field on the other half of the room from you.

The entity suddenly leaps up and clings to the ceiling. Its face changes to an expression of confusion.
.

* * *

>s
You can't go that way.

The entity ripples, as if a giant worm is crawling around just under the surface of its skin.

>look entity
There is a naked, flesh-colored humanoid thing across the room from you. It seems to be bounded to its half of the room by an invisible force field.

I ADMIRE YOUR INQUISITIVE NATURE!

The entity gurgles softly to itself, and jams a finger into its own eye.
.

[Your score has just gone up by five points.]

>look entity
There is a naked, flesh-colored humanoid thing across the room from you. It seems to be bounded to its half of the room by an invisible force field.

The entity stares at you. You feel a dull ache in the base of your spine.
.

>z
Time passes.

The entity sucks in air, its ribcabe jutting out as its torso compresses into an impossible skinniness.
.

>z
Time passes.

The entity suddenly leaps up and clings to the ceiling. Its face changes to an expression of confusion.
.

>z
Time passes.

The entity's skin bubbles.
.

>look button
A glowing red button. It delivers new alloys when you use up the old ones.

I ADMIRE YOUR EXPLORATORY NATURE!

The entity ripples, as if a giant worm is crawling around just under the surface of its skin.
.

[Your score has just gone up by five points.]

>press button
The entity grins at you. Well, not so much "grin" as "curl back its lips and roll its eyes back into its head."
.

I beg your pardon?

>press button
The entity ripples, as if a giant worm is crawling around just under the surface of its skin.
.

* * *

>s
You can't go that way.

The entity ripples, as if a giant worm is crawling around just under the surface of its skin.

>n
Combination Station

You are standing in another concrete room. There are exits to the North and South. In the center is a vast machine labeled 'Combinator'. The machine has 3 slots to put elements in:

Slot 1 is empty.

Slot 2 is empty.

Slot 3 is empty.

You can also see a green button labelled GO and Intern Jim here.

I beg your pardon?

>n
Supply Room
You are standing in a spacious room made of reinforced concrete. A lighting panel illuminates the room in a tense white glow. There is another room to the south.

An alcove is carved into the wall in front of you. Hovering in the alcove are a SHIELD alloy, a BLADE alloy, an ENTROPIC alloy, a MEND alloy and a SPARK alloy.

A large red button labeled RESUPPLY is mounted above the alcove.

>take mend
Taken.

>s
Combination Station

You are standing in another concrete room. There are exits to the North and South. In the center is a vast machine labeled 'Combinator'. The machine has 3 slots to put elements in:

Slot 1 is empty.

Slot 2 is empty.

Slot 3 is empty.

You can also see a green button labelled GO and Intern Jim here.

>give mend to jim
Intern Jim doesn't seem interested.

>jim, jump
Intern Jim has better things to do.

* * *

>s
Arena
STUDIES HAVE SHOWN THAT CREATIVITY IS BOOSTED BY 57% UPON THE INTRODUCTION OF A HOSTILE ENTITY! THUS, WE HAVE PROVIDED AN ENEMY FOR YOU TO DEFEAT IN THIS ROOM. PRESS THE BUTTON WHEN YOU FEEL YOU ARE READY TO FIGHT IT!

This is another large, barren concrete room. Exits are to the north and south.

There is a hostile entity trapped by a force field on the other half of the room from you.

The entity grins at you. Well, not so much "grin" as "curl back its lips and roll its eyes back into its head."

>x
(the hostile entity)
There is a naked, flesh-colored humanoid thing across the room from you. It seems to be bounded to its half of the room by an invisible force field. It's hard to remember what it looks like.

I ADMIRE YOUR INQUISITIVE NATURE!

The entity ripples, as if a giant worm is crawling around just under the surface of its skin.
.

[Your score has just gone up by five points.]

>look
Arena

This is another large, barren concrete room. Exits are to the north and south.

There is a hostile entity trapped by a force field on the other half of the room from you.

The entity gurgles softly to itself, and jams a finger into its own eye.
.

* * *

>s
Arena
STUDIES HAVE SHOWN THAT CREATIVITY IS BOOSTED BY 57% UPON THE INTRODUCTION OF A HOSTILE ENTITY! THUS, WE HAVE PROVIDED AN ENEMY FOR YOU TO DEFEAT IN THIS ROOM. PRESS THE BUTTON WHEN YOU FEEL YOU ARE READY TO FIGHT IT!

This is another large, barren concrete room. Exits are to the north and south.

There is a hostile entity trapped by a force field on the other half of the room from you.

The entity grins at you. Well, not so much "grin" as "curl back its lips and roll its eyes back into its head."

>z
Time passes.

The entity ripples, as if a giant worm is crawling around just under the surface of its skin.

* * *

>s
Combination Station
WELCOME TO THE QUALIFICATION DETERMINATION SIMULATION COMBINATION STATION! HERE YOU CAN TAKE ALLOYS FROM THE PREVIOUS ROOM AND FORM THEM INTO NEW AND FANCIFUL CREATIONS. WHAT ARE YOU WAITING FOR? LET'S GET CREATIVE!

You are standing in another concrete room. There are exits to the North and South. In the center is a vast machine labeled 'Combinator'. The machine has 3 slots to put alloys in:

Slot 1 is empty.

Slot 2 is empty.

Slot 3 is empty.

You can also see a green button labelled GO and Intern Jim here.

>take machine
That's fixed in place.

* * *

>s
Combination Station
WELCOME TO THE QUALIFICATION DETERMINATION SIMULATION COMBINATION STATION! HERE YOU CAN TAKE ALLOYS FROM THE PREVIOUS ROOM AND FORM THEM INTO NEW AND FANCIFUL CREATIONS. WHAT ARE YOU WAITING FOR? LET'S GET CREATIVE!

You are standing in another concrete room. There are exits to the North and South. In the center is a vast machine labeled 'Combinator'. The machine has 3 slots to put alloys in:

Slot 1 is empty.

Slot 2 is empty.

Slot 3 is empty.

You can also see a green button labelled GO and Intern Jim here.

>talk to Jim
That's not a verb I recognise.

>talk Jim
That's not a verb I recognise.

>ask Jim about Jim
There is no reply.

>ask Jim about me
There is no reply.

* * *

>s
Combination Station
WELCOME TO THE QUALIFICATION DETERMINATION SIMULATION COMBINATION STATION! HERE YOU CAN TAKE ALLOYS FROM THE PREVIOUS ROOM AND FORM THEM INTO NEW AND FANCIFUL CREATIONS. WHAT ARE YOU WAITING FOR? LET'S GET CREATIVE!

You are standing in another concrete room. There are exits to the North and South. In the center is a vast machine labeled 'Combinator'. The machine has 3 slots to put alloys in:

Slot 1 is empty.

Slot 2 is empty.

Slot 3 is empty.

You can also see a green button labelled GO and Intern Jim here.

>talk to jim about jim
That's not a verb I recognise.

>ask jim about jim
"Oh, I'm just an Artificially Intelligent intern. Feel free to order me around, test weapons on me..."

 He notices your confused expression.

 "I'll regenerate if you do any real harm. Fire away!"

>ask jim about me
"You're an applicant for Creativitrix! Keep pumping out creativity and you'll be an endpoint in no time."

>ask jim about myself
"You're an applicant for Creativitrix! Keep pumping out creativity and you'll be an endpoint in no time."

>ask jim about him
"Oh, I'm just an Artificially Intelligent intern. Feel free to order me around, test weapons on me..."

 He notices your confused expression.

 "I'll regenerate if you do any real harm. Fire away!"

* * *

>s
Combination Station
WELCOME TO THE QUALIFICATION DETERMINATION SIMULATION COMBINATION STATION! HERE YOU CAN TAKE ALLOYS FROM THE PREVIOUS ROOM AND FORM THEM INTO NEW AND FANCIFUL CREATIONS. WHAT ARE YOU WAITING FOR? LET'S GET CREATIVE!

You are standing in another concrete room. There are exits to the North and South. In the center is a vast machine labeled 'Combinator'. The machine has 3 slots to put alloys in:

Slot 1 is empty.

Slot 2 is empty.

Slot 3 is empty.

You can also see a green button labelled GO and Intern Jim here.

>tell jim about heat
"It's appalling, isn't it? You'd think we didn't pay our taxes."

* * *

>s
Combination Station
WELCOME TO THE QUALIFICATION DETERMINATION SIMULATION COMBINATION STATION! HERE YOU CAN TAKE ALLOYS FROM THE PREVIOUS ROOM AND FORM THEM INTO NEW AND FANCIFUL CREATIONS. WHAT ARE YOU WAITING FOR? LET'S GET CREATIVE!

You are standing in another concrete room. There are exits to the North and South. In the center is a vast machine labeled 'Combinator'. The machine has 3 slots to put alloys in:

Slot 1 is empty.

Slot 2 is empty.

Slot 3 is empty.

You can also see a green button labelled GO and Intern Jim here.

>x machine
It's pretty neat.

* * *

 

 

Supply Room
You are standing in a spacious room made of reinforced concrete. A lighting panel illuminates the room in a tense white glow. There is another room to the SOUTH.

An alcove is carved into the wall in front of you. Hovering in the alcove are a SHIELD alloy, a BLADE alloy, an ENTROPIC alloy, a MEND alloy and a SPARK alloy.

A large red button labeled RESUPPLY is mounted above the alcove.

>smell mend
The soothing scent of lavender washes over you. You close your eyes and enjoy it for a moment.

You smell nothing unexpected.

I beg your pardon?

* * *

 

 

Supply Room
You are standing in a spacious room made of reinforced concrete. A lighting panel illuminates the room in a tense white glow. There is another room to the SOUTH.

An alcove is carved into the wall in front of you. Hovering in the alcove are a SHIELD alloy, a BLADE alloy, an ENTROPIC alloy, a MEND alloy and a SPARK alloy.

A large red button labeled RESUPPLY is mounted above the alcove.

>smell table
Smells woody.

* * *

 

 

Supply Room
You are standing in a spacious room made of reinforced concrete. A lighting panel illuminates the room in a tense white glow. There is another room to the SOUTH.

An alcove is carved into the wall in front of you. Hovering in the alcove are a SHIELD alloy, a BLADE alloy, an ENTROPIC alloy, a MEND alloy and a SPARK alloy.

A large red button labeled RESUPPLY is mounted above the alcove.

>smells like a mosue
That's not a verb I recognise.

>smell mouse
Smells like a mouse.

* * *

 

 

Supply Room
You are standing in a spacious room made of reinforced concrete. A lighting panel illuminates the room in a tense white glow. There is another room to the SOUTH.

An alcove is carved into the wall in front of you. Hovering in the alcove are a SHIELD alloy, a BLADE alloy, an ENTROPIC alloy, a MEND alloy and a SPARK alloy.

A large red button labeled RESUPPLY is mounted above the alcove.

>ss
That's not a verb I recognise.

>s
Combination Station
WELCOME TO THE QUALIFICATION DETERMINATION SIMULATION COMBINATION STATION! HERE YOU CAN TAKE ELEMENTS FROM THE PREVIOUS ROOM AND FORM THEM INTO NEW AND FANCIFUL CREATIONS. WHAT ARE YOU WAITING FOR? LET'S GET CREATIVE!

You are standing in another concrete room. There are exits to the North and South. In the center is a vast machine labeled 'Combinator'. The machine has 3 slots to put elements in:

Slot 1 is empty.

Slot 2 is empty.

Slot 3 is empty.

You can also see a green button labelled GO and Intern Jim here.

>attack jim
You attack Intern Jim, causing 8 points of damage!

Intern Jim expires, and is immediately carried away by the Arena slaves!

    *** The End ***

In that game you scored 0 out of a possible 0, in 2 turns.

Would you like to RESTART, RESTORE a saved game, QUIT or UNDO the last command?

* * *

 

 

Supply Room
You are standing in a spacious room made of reinforced concrete. A lighting panel illuminates the room in a tense white glow. There is another room to the SOUTH.

An alcove is carved into the wall in front of you. Hovering in the alcove are a SHIELD alloy, a BLADE alloy, an ENTROPIC alloy, a MEND alloy and a SPARK alloy.

A large red button labeled RESUPPLY is mounted above the alcove.

>take alcove
You place both hands on the stone beside the alcove and try to rip it out of the wall. Unfortunately, you aren't very Incredible or Hulking.

YOU CAN'T TAKE THAT ALCOVE. NICE IDEA, THOUGH!

[Your score has just gone up by five points.]

* * *

 

 

Supply Room
You are standing in a spacious room made of reinforced concrete. A lighting panel illuminates the room in a tense white glow. There is another room to the SOUTH.

An alcove is carved into the wall in front of you. Hovering in the alcove are a SHIELD alloy, a BLADE alloy, an ENTROPIC alloy, a MEND alloy and a SPARK alloy.

A large red button labeled RESUPPLY is mounted above the alcove.

>take all
You should only take 3 elements at a time - that's how many you can

>s
Combination Station
WELCOME TO THE QUALIFICATION DETERMINATION SIMULATION COMBINATION STATION! HERE YOU CAN TAKE ELEMENTS FROM THE PREVIOUS ROOM AND FORM THEM INTO NEW AND FANCIFUL CREATIONS. WHAT ARE YOU WAITING FOR? LET'S GET CREATIVE!

You are standing in another concrete room. There are exits to the North and South. In the center is a vast machine labeled 'Combinator'. The machine has 3 slots to put elements in:

Slot 1 is empty.

Slot 2 is empty.

Slot 3 is empty.

You can also see a green button labelled GO here.

>take all
vast machine labeled 'Combinator': Taken.

>look
Combination Station

You are standing in another concrete room. There are exits to the North and South. In the center is a vast machine labeled 'Combinator'. The machine has 3 slots to put elements in:

Slot 1 is empty.

Slot 2 is empty.

Slot 3 is empty.

You can also see a green button labelled GO here.

* * *

>take all
You should only take 3 elements at a time - that's how many you can

>take mend and spark
MEND alloy: Test this
Taken.
SPARK alloy: Test 
Taken.

>s
Combination Station
WELCOME TO THE QUALIFICATION DETERMINATION SIMULATION COMBINATION STATION! HERE YOU CAN TAKE ELEMENTS FROM THE PREVIOUS ROOM AND FORM THEM INTO NEW AND FANCIFUL CREATIONS. WHAT ARE YOU WAITING FOR? LET'S GET CREATIVE!

You are standing in another concrete room. There are exits to the North and South. In the center is a vast machine labeled 'Combinator'. The machine has 3 slots to put elements in:

Slot 1 is empty.

Slot 2 is empty.

>put mend and spark in slot
(slot 1)
MEND alloy: Slot 1 is full, so let's put MEND alloy in slot 2.

Done.
SPARK alloy: Done.

* * *

>take all
You should only take 3 elements at a time - that's how many you can

>take shield, blade and entropic
SHIELD alloy: Test this
Taken.
BLADE alloy: Test 
Taken.
ENTROPIC alloy: Test 
Taken.

>s
Combination Station
WELCOME TO THE QUALIFICATION DETERMINATION SIMULATION COMBINATION STATION! HERE YOU CAN TAKE ELEMENTS FROM THE PREVIOUS ROOM AND FORM THEM INTO NEW AND FANCIFUL CREATIONS. WHAT ARE YOU WAITING FOR? LET'S GET CREATIVE!

You are standing in another concrete room. There are exits to the North and South. In the center is a vast machine labeled 'Combinator'. The machine has 3 slots to put elements in:

Slot 1 is empty.

Slot 2 is empty.

Slot 3 is empty.

You can also see a green button labelled GO here.

>look button
A glowing red button. PRESS THIS BUTTON IF YOU NEED MORE ALLOYS.

I ADMIRE YOUR INQUISITIVE NATURE!

[Your score has just gone up by five points.]

>press button
rate 5 stars
THANK YOU FOR YOUR FEEDBACK!

>press button
You can't press GO if there's an empty slot!

>look
Combination Station

You are standing in another concrete room. There are exits to the North and South. In the center is a vast machine labeled 'Combinator'. The machine has 3 slots to put elements in:

Slot 1 is empty.

Slot 2 is empty.

Slot 3 is empty.

You can also see a green button labelled GO here.

>x slot 1
rate 3 stars
THANK YOU FOR YOUR FEEDBACK!
UH... ACTUALLY LOOKS LIKE THE RATINGS MODULE IS BACK AGAIN WITH ANOTHER RATING! WHAT HAVE YOU GOT TO SAY LITTLE GUY?

 Please rate your experience using the RATING MODULE thus far:

5 - Perfect in every way

4 - Quite good

3 - Meh

2 - Unsatisfactory

1 - Literally painful

>look
rate 1 stars

* * *

>take all
You should only take 3 elements at a time - that's how many you can

>take spark and mend
SPARK alloy: Test this
Taken.
MEND alloy: Test 
Taken.

>s
Combination Station
WELCOME TO THE QUALIFICATION DETERMINATION SIMULATION COMBINATION STATION! HERE YOU CAN TAKE ELEMENTS FROM THE PREVIOUS ROOM AND FORM THEM INTO NEW AND FANCIFUL CREATIONS. WHAT ARE YOU WAITING FOR? LET'S GET CREATIVE!

You are standing in another concrete room. There are exits to the North and South. In the center is a vast machine labeled 'Combinator'. The machine has 3 slots to put elements in:

Slot 1 contains nothing.

Slot 2 contains nothing.

>put all into 1
MEND alloy: Done.
SPARK alloy: Done.

>take all
vast machine labeled 'Combinator': Taken.
slot 1: Taken.
slot 2: Taken.
MEND alloy: Test 
Taken.
SPARK alloy: Test 
Taken.

* * *

 

 

Supply Room
You are standing in a spacious room made of reinforced concrete. A lighting panel illuminates the room in a tense white glow. There is another room to the SOUTH.

An alcove is carved into the wall in front of you. Hovering in the alcove are a SHIELD alloy, a BLADE alloy, an ENTROPIC alloy, a MEND alloy and a SPARK alloy.

A large red button labeled RESUPPLY is mounted above the alcove.

>take alloy
Which do you mean, the BLADE alloy, the ENTROPIC alloy, the SALVE alloy, the SPARK alloy or the SHIELD alloy?

>shield
Taken.

>x shield
You see nothing special about the SHIELD alloy.

>x shie
You can't see any such thing.

* * *

>take alloy
Which do you mean, the BLADE alloy, the ENTROPIC alloy, the SALVE alloy, the SPARK alloy or the SHIELD alloy?

>take blade
Taken.

>take shield
Test this
Taken.

>drop shield
Dropped.

>take shield
Test 
Taken.

* * *

 

 

Supply Room
You are standing in a spacious room made of reinforced concrete. A lighting panel illuminates the room in a tense white glow. There is another room to the SOUTH.

An alcove is carved into the wall in front of you. Hovering in the alcove are a SHIELD alloy, a BLADE alloy, an ENTROPIC alloy, a MEND alloy and a SPARK alloy.

A large red button labeled RESUPPLY is mounted above the alcove.

>take blade
Test this
Taken.

>s
Combination Station
WELCOME TO THE QUALIFICATION DETERMINATION SIMULATION COMBINATION STATION! HERE YOU CAN TAKE ELEMENTS FROM THE PREVIOUS ROOM AND FORM THEM INTO NEW AND FANCIFUL CREATIONS. WHAT ARE YOU WAITING FOR? LET'S GET CREATIVE!

You are standing in another concrete room. There are exits to the North and South. In the center is a vast machine labeled 'Combinator'. The machine has 3 slots to put elements in:

Slot 1 is empty.

Slot 2 is empty.

Slot 3 is empty.

You can also see a green button labelled GO here.

>put blade in slot
(slot 1)
You put the BLADE alloy into slot 1.

>press go
INgredients: BLADE alloyNice blade bruh.

HELLO AGAIN! I'D LIKE TO INTRODUCE... THE RATINGS MODULE! HUMAN FEEDBACK IS CRUCIAL TO CREATIVITRIX, AND THIS LITTLE GUY IS HERE TO COLLECT IT! I'LL LET HIM TALK:

 Please rate your experience with the CREATIVITRIX QUALIFICATION DETERMINATION SIMULATION thus far:

5 - Excellent

4 - Appealing

3 - Unremarkable

2 - Lackluster

1 - Truly Awful

>look
Combination Station

You are standing in another concrete room. There are exits to the North and South. In the center is a vast machine labeled 'Combinator'. The machine has 3 slots to put elements in:

Slot 1 contains a BLADE alloy.

Slot 2 is empty.

Slot 3 is empty.

You can also see a green button labelled GO here.

>look machine
rate 5 stars
THE RATING MODULE RAN AWAY... IT USUALLY LIKES HIDING DOWN BY THE STRING TABLES IN MAIN MEMORY, SO IT'LL PROBABLY BE FINE. IN THE MEANTIME, HOLD OFF ON RATING ANYTHING.

* * *

 

 

Supply Room
You are standing in a spacious room made of reinforced concrete. A lighting panel illuminates the room in a tense white glow. There is another room to the SOUTH.

An alcove is carved into the wall in front of you. Hovering in the alcove are a SHIELD alloy, a BLADE alloy, an ENTROPIC alloy, a MEND alloy and a SPARK alloy.

A large red button labeled RESUPPLY is mounted above the alcove.

>take blade shield and entropic
I only understood you as far as wanting to take the BLADE alloy.

>take blade, shield and entropic
BLADE alloy: Test this
Taken.
SHIELD alloy: Test 
Taken.
ENTROPIC alloy: Test 
Taken.

>combine
Combination Station
WELCOME TO THE QUALIFICATION DETERMINATION SIMULATION COMBINATION STATION! HERE YOU CAN TAKE ELEMENTS FROM THE PREVIOUS ROOM AND FORM THEM INTO NEW AND FANCIFUL CREATIONS. WHAT ARE YOU WAITING FOR? LET'S GET CREATIVE!

You are standing in another concrete room. There are exits to the North and South. In the center is a vast machine labeled 'Combinator'. The machine has 3 slots to put elements in:

Slot 1 is empty.

Slot 2 is empty.

Slot 3 is empty.

You can also see a green button labelled GO here.

You put the SHIELD alloy into slot 1.

Slot 1 is full, so let's put BLADE alloy in slot 2. You put the BLADE alloy into slot 2.

Slot 1 is full, so let's put ENTROPIC alloy in slot 2. Slot 2 is full, so let's put ENTROPIC alloy in slot 3. You put the ENTROPIC alloy into slot 3.

* * *

 

 

Supply Room
You are standing in a spacious room made of reinforced concrete. A lighting panel illuminates the room in a tense white glow. There is another room to the SOUTH.

An alcove is carved into the wall in front of you. Hovering in the alcove are a SHIELD alloy, a BLADE alloy, an ENTROPIC alloy, a MEND alloy and a SPARK alloy.

A large red button labeled RESUPPLY is mounted above the alcove.

>take blade, entropic and mend
BLADE alloy: Test this
Taken.
ENTROPIC alloy: Test 
Taken.
MEND alloy: Test 
Taken.

>combine
Combination Station
WELCOME TO THE QUALIFICATION DETERMINATION SIMULATION COMBINATION STATION! HERE YOU CAN TAKE ELEMENTS FROM THE PREVIOUS ROOM AND FORM THEM INTO NEW AND FANCIFUL CREATIONS. WHAT ARE YOU WAITING FOR? LET'S GET CREATIVE!

You are standing in another concrete room. There are exits to the North and South. In the center is a vast machine labeled 'Combinator'. The machine has 3 slots to put elements in:

Slot 1 is empty.

Slot 2 is empty.

Slot 3 is empty.

You can also see a green button labelled GO here.

You put the BLADE alloy into slot 1.

Slot 1 is full, so let's put ENTROPIC alloy in slot 2. You put the ENTROPIC alloy into slot 2.

Slot 1 is full, so let's put MEND alloy in slot 2. Slot 2 is full, so let's put MEND alloy in slot 3. You put the MEND alloy into slot 3.

>press go
INgredients: BLADE alloy, ENTROPIC alloy and MEND alloyThe

>take blade
rate 5 stars
THANK YOU FOR YOUR FEEDBACK!

>press go
You can't press GO if there's an empty slot!

>look
Combination Station

You are standing in another concrete room. There are exits to the North and South. In the center is a vast machine labeled 'Combinator'. The machine has 3 slots to put elements in:

Slot 1 is empty.

Slot 2 contains an ENTROPIC alloy.

Slot 3 contains a MEND alloy.

You can also see a green button labelled GO here.

* * *

 

 

Supply Room
You are standing in a spacious room made of reinforced concrete. A lighting panel illuminates the room in a tense white glow. There is another room to the SOUTH.

An alcove is carved into the wall in front of you. Hovering in the alcove are a SHIELD alloy, a BLADE alloy, an ENTROPIC alloy, a MEND alloy and a SPARK alloy.

A large red button labeled RESUPPLY is mounted above the alcove.

>take blade, entropic and spark
BLADE alloy: Test this
Taken.
ENTROPIC alloy: Test 
Taken.
SPARK alloy: Test 
Taken.

>combine
Combination Station
WELCOME TO THE QUALIFICATION DETERMINATION SIMULATION COMBINATION STATION! HERE YOU CAN TAKE ELEMENTS FROM THE PREVIOUS ROOM AND FORM THEM INTO NEW AND FANCIFUL CREATIONS. WHAT ARE YOU WAITING FOR? LET'S GET CREATIVE!

You are standing in another concrete room. There are exits to the North and South. In the center is a vast machine labeled 'Combinator'. The machine has 3 slots to put elements in:

Slot 1 is empty.

Slot 2 is empty.

Slot 3 is empty.

You can also see a green button labelled GO here.

You put the BLADE alloy into slot 1.

Slot 1 is full, so let's put ENTROPIC alloy in slot 2. You put the ENTROPIC alloy into slot 2.

Slot 1 is full, so let's put SPARK alloy in slot 2. Slot 2 is full, so let's put SPARK alloy in slot 3. You put the SPARK alloy into slot 3.

>press go
Ingredient list: BLADE alloy, ENTROPIC alloy and SPARK alloyThe BLADE and ENTROPIC alloys wrap themselves in a tight coil, spiraling around the room! The SPARK alloy suddenly arcs out and takes control of the tendril with electrical impulses, leaving a handle that's (relatively) safe to grab.

* * *

 

 

Supply Room
You are standing in a spacious room made of reinforced concrete. A lighting panel illuminates the room in a tense white glow. There is another room to the SOUTH.

An alcove is carved into the wall in front of you. Hovering in the alcove are a SHIELD alloy, a BLADE alloy, an ENTROPIC alloy, a MEND alloy and a SPARK alloy.

A large red button labeled RESUPPLY is mounted above the alcove.

>take blade, mend and entropic
BLADE alloy: Test this
Taken.
MEND alloy: Test 
Taken.
ENTROPIC alloy: Test 
Taken.

>combine
Combination Station
WELCOME TO THE QUALIFICATION DETERMINATION SIMULATION COMBINATION STATION! HERE YOU CAN TAKE ELEMENTS FROM THE PREVIOUS ROOM AND FORM THEM INTO NEW AND FANCIFUL CREATIONS. WHAT ARE YOU WAITING FOR? LET'S GET CREATIVE!

You are standing in another concrete room. There are exits to the North and South. In the center is a vast machine labeled 'Combinator'. The machine has 3 slots to put elements in:

Slot 1 is empty.

Slot 2 is empty.

Slot 3 is empty.

You can also see a green button labelled GO here.

You put the BLADE alloy into slot 1.

Slot 1 is full, so let's put ENTROPIC alloy in slot 2. You put the ENTROPIC alloy into slot 2.

Slot 1 is full, so let's put MEND alloy in slot 2. Slot 2 is full, so let's put MEND alloy in slot 3. You put the MEND alloy into slot 3.

>press go
INgredients: BLADE alloy, ENTROPIC alloy and MEND alloyThe BLADE alloy warps itself into a long syringe, and the MELD alloy fills it with a healing light! But then, the ENTROPIC alloy corrupts it into a nasty-looking poison!

* * *

 

 

Supply Room
You are standing in a spacious room made of reinforced concrete. A lighting panel illuminates the room in a tense white glow. There is another room to the SOUTH.

An alcove is carved into the wall in front of you. Hovering in the alcove are a SHIELD alloy, a BLADE alloy, an ENTROPIC alloy, a MEND alloy and a SPARK alloy.

A large red button labeled RESUPPLY is mounted above the alcove.

>take blade, shield and entropy
You can't see any such thing.

>take blade, shield and entropic
BLADE alloy: Test this
Taken.
SHIELD alloy: Test 
Taken.
ENTROPIC alloy: Test 
Taken.

* * *

>press go
Ingredient list: SHIELD alloy, BLADE alloy and ENTROPIC alloy

* * *

 

 

Supply Room
You are standing in a spacious room made of reinforced concrete. A lighting panel illuminates the room in a tense white glow. There is another room to the SOUTH.

An alcove is carved into the wall in front of you. Hovering in the alcove are a SHIELD alloy, a BLADE alloy, an ENTROPIC alloy, a MEND alloy and a SPARK alloy.

A large red button labeled RESUPPLY is mounted above the alcove.

>take blade, shield and mend
BLADE alloy: Test this
Taken.
SHIELD alloy: Test 
Taken.
MEND alloy: Test 
Taken.

>combine
Combination Station
WELCOME TO THE QUALIFICATION DETERMINATION SIMULATION COMBINATION STATION! HERE YOU CAN TAKE ELEMENTS FROM THE PREVIOUS ROOM AND FORM THEM INTO NEW AND FANCIFUL CREATIONS. WHAT ARE YOU WAITING FOR? LET'S GET CREATIVE!

You are standing in another concrete room. There are exits to the North and South. In the center is a vast machine labeled 'Combinator'. The machine has 3 slots to put elements in:

Slot 1 is empty.

Slot 2 is empty.

Slot 3 is empty.

You can also see a green button labelled GO here.

You put the SHIELD alloy into slot 1.

Slot 1 is full, so let's put BLADE alloy in slot 2. You put the BLADE alloy into slot 2.

Slot 1 is full, so let's put MEND alloy in slot 2. Slot 2 is full, so let's put MEND alloy in slot 3. You put the MEND alloy into slot 3.

>press go
Ingredient list: BLADE alloy, MEND alloy and SHIELD alloyThe BLADE alloy warps itself into a long syringe, and the MEND alloy fills it with a healing light! The SHIELD alloy reinforces the syringe and gives the chemical inside a fortifying property.

>n
Supply Room
You are standing in a spacious room made of reinforced concrete. A lighting panel illuminates the room in a tense white glow. There is another room to the south.

An alcove is carved into the wall in front of you. Hovering in the alcove are an ENTROPIC alloy and a SPARK alloy.

A large red button labeled RESUPPLY is mounted above the alcove.

You can also see a SHIELD alloy, a MEND alloy and a BLADE alloy here.

HELLO AGAIN! I'D LIKE TO INTRODUCE... THE RATINGS MODULE! HUMAN FEEDBACK IS CRUCIAL TO CREATIVITRIX, AND THIS LITTLE GUY IS HERE TO COLLECT IT! I'LL LET HIM TALK:

 Please rate your experience with the CREATIVITRIX QUALIFICATION DETERMINATION SIMULATION thus far:

5 - Excellent

4 - Appealing

3 - Unremarkable

2 - Lackluster

1 - Truly Awful

* * *

>take blade, shield and mend
BLADE alloy: Test this
Taken.
SHIELD alloy: Test 
Taken.
MEND alloy: Test 
Taken.

>s
Combination Station
WELCOME TO THE QUALIFICATION DETERMINATION SIMULATION COMBINATION STATION! HERE YOU CAN TAKE ELEMENTS FROM THE PREVIOUS ROOM AND FORM THEM INTO NEW AND FANCIFUL CREATIONS. WHAT ARE YOU WAITING FOR? LET'S GET CREATIVE!

You are standing in another concrete room. There are exits to the North and South. In the center is a vast machine labeled 'Combinator'. The machine has 3 slots to put elements in:

Slot 1 is empty.

Slot 2 is empty.

Slot 3 is empty.

You can also see a green button labelled GO here.

>put blade, shield and mend in slot
(slot 1)
BLADE alloy: Done.
SHIELD alloy: Slot 1 is full, so let's put SHIELD alloy in slot 2. Done.
MEND alloy: Slot 1 is full, so let's put MEND alloy in slot 2. Slot 2 is full, so let's put MEND alloy in slot 3. Done.

>z
rate 5 stars
THANK YOU FOR YOUR FEEDBACK!

>x blade
rate 2 stars
THE RATING MODULE RAN AWAY... IT USUALLY LIKES HIDING DOWN BY THE STRING TABLES IN MAIN MEMORY, SO IT'LL PROBABLY BE FINE. IN THE MEANTIME, HOLD OFF ON RATING ANYTHING.

* * *

 

 

Supply Room
You are standing in a spacious room made of reinforced concrete. A lighting panel illuminates the room in a tense white glow. There is another room to the SOUTH.

An alcove is carved into the wall in front of you. Hovering in the alcove are a SHIELD alloy, a BLADE alloy, an ENTROPIC alloy, a MEND alloy and a SPARK alloy.

A large red button labeled RESUPPLY is mounted above the alcove.

>take button
YOU CAN'T TAKE THAT LARGE RED BUTTON LABELED RESUPPLY. NICE IDEA, THOUGH!

[Your score has just gone up by five points.]

>s
Combination Station
WELCOME TO THE QUALIFICATION DETERMINATION SIMULATION COMBINATION STATION! HERE YOU CAN TAKE ELEMENTS FROM THE PREVIOUS ROOM AND FORM THEM INTO NEW AND FANCIFUL CREATIONS. WHAT ARE YOU WAITING FOR? LET'S GET CREATIVE!

You are standing in another concrete room. There are exits to the North and South. In the center is a vast machine labeled 'Combinator'. The machine has 3 slots to put elements in:

Slot 1 is empty.

Slot 2 is empty.

Slot 3 is empty.

You can also see a green button labelled GO here.

>take button
You wrap your fingers around and try to pry
YOU CAN'T TAKE THAT GREEN BUTTON LABELLED GO. NICE IDEA, THOUGH!

[Your score has just gone up by five points.]

* * *

>take button
YOU CAN'T TAKE THAT LARGE RED BUTTON LABELED RESUPPLY. NICE IDEA, THOUGH!

[Your score has just gone up by five points.]

>take alcove
YOU CAN'T TAKE THAT ALCOVE. NICE IDEA, THOUGH!

[Your score has just gone up by five points.]

>take alcove
That's fixed in place.

* * *

>s
Combination Station
WELCOME TO THE QUALIFICATION DETERMINATION SIMULATION COMBINATION STATION! HERE YOU CAN TAKE ALLOYS FROM THE PREVIOUS ROOM AND FORM THEM INTO NEW AND FANCIFUL CREATIONS. WHAT ARE YOU WAITING FOR? LET'S GET CREATIVE!

You are standing in another concrete room. There are exits to the North and South. In the center is a vast machine labeled 'Combinator'. The machine has 3 slots to put alloys in:

Slot 1 is empty.

Slot 2 is empty.

Slot 3 is empty.

You can also see a green button labelled GO and Intern Jim here.

>give jim mend
Intern Jim oh boy You give the MEND alloy to Intern Jim.

>jim, give me the mend
Intern Jim gives the MEND alloy to you.

>give mend to jim
Intern Jim oh boy You give the MEND alloy to Intern Jim.

* * *

>look
Combination Station

You are standing in another concrete room. There are exits to the North and South. In the center is a vast machine labeled 'Combinator'. The machine has 3 slots to put alloys in:

Slot 1 is empty.

Slot 2 is empty.

Slot 3 is empty.

You can also see a green button labelled GO and Intern Jim here.

* * *

>s
Combination Station
WELCOME TO THE QUALIFICATION DETERMINATION SIMULATION COMBINATION STATION! HERE YOU CAN TAKE ALLOYS FROM THE PREVIOUS ROOM AND FORM THEM INTO NEW AND FANCIFUL CREATIONS. WHAT ARE YOU WAITING FOR? LET'S GET CREATIVE!

You are standing in another concrete room. There are exits to the North and South. In the center is a vast machine labeled 'Combinator'. The machine has 3 slots to put alloys in:

Slot 1 is empty.

Slot 2 is empty.

Slot 3 is empty.

You can also see a green button labelled GO and Intern Jim here.

>give mend to jim
yourself oh boy You give the MEND alloy to Intern Jim.

* * *

>put mend in slot
You put the MEND alloy into slot 1.

>n
Supply Room
You are standing in a spacious room made of reinforced concrete. A lighting panel illuminates the room in a tense white glow. There is another room to the south.

An alcove is carved into the wall in front of you. Hovering in the alcove are a SHIELD alloy, a BLADE alloy, an ENTROPIC alloy and a SPARK alloy.

A large red button labeled RESUPPLY is mounted above the alcove.

* * *

>s
Combination Station

You are standing in another concrete room. There are exits to the North and South. In the center is a vast machine labeled 'Combinator'. The machine has 3 slots to put elements in:

Slot 1 is empty.

>put spark in slot
That slot already has something in it.

* * *

>s
Combination Station
WELCOME TO THE QUALIFICATION DETERMINATION SIMULATION COMBINATION STATION! HERE YOU CAN TAKE ALLOYS FROM THE PREVIOUS ROOM AND FORM THEM INTO NEW AND FANCIFUL CREATIONS. WHAT ARE YOU WAITING FOR? LET'S GET CREATIVE!

You are standing in another concrete room. There are exits to the North and South. In the center is a vast machine labeled 'Combinator'. The machine has 3 slots to put alloys in:

Slot 1 is empty.

Slot 2 is empty.

Slot 3 is empty.

You can also see a green button labelled GO and Intern Jim here.

>put mend into slot
You put the MEND alloy into slot 1.

>look
Combination Station

You are standing in another concrete room. There are exits to the North and South. In the center is a vast machine labeled 'Combinator'. The machine has 3 slots to put elements in:

Slot 1 is empty.

>look
Combination Station

You are standing in another concrete room. There are exits to the North and South. In the center is a vast machine labeled 'Combinator'. The machine has 3 slots to put elements in:

Slot 1 is empty.

>x slot
In slot 1 is a MEND alloy.

* * *

>s
Arena
STUDIES HAVE SHOWN THAT CREATIVITY IS BOOSTED BY 57% UPON THE INTRODUCTION OF A HOSTILE ENTITY! THUS, WE HAVE PROVIDED AN ENEMY FOR YOU TO DEFEAT IN THIS ROOM. PRESS THE BUTTON WHEN YOU FEEL YOU ARE READY TO FIGHT IT!

This is another large, barren concrete room. Exits are to the north and south.

There is a hostile entity trapped by a force field on the other half of the room from you.

The entity grins at you. Well, not so much "grin" as "curl back its lips and roll its eyes back into its head."

>give mend to entity
The entity whips the MEND alloy out of your hand and on to the floor.

The entity ripples, as if a giant worm is crawling around just under the surface of its skin.

>look
Arena

This is another large, barren concrete room. Exits are to the north and south.

There is a hostile entity trapped by a force field on the other half of the room from you.

You can also see a MEND alloy here.

The entity gurgles softly to itself, and jams a finger into its own eye.

>take mend
Taken.

The entity stares at you. You feel a dull ache in the base of your spine.

>kiss entity
EXCELLENT! BE SURE TO INSPECT YOUR ENVIRONMENT CAREFULLY!

The entity sucks in air, its ribcabe jutting out as its torso compresses into an impossible skinniness.

[Your score has just gone up by five points.]

>kiss entity
The entity suddenly leaps up and clings to the ceiling. Its face changes to an expression of confusion.

* * *

>s
Arena
STUDIES HAVE SHOWN THAT CREATIVITY IS BOOSTED BY 57% UPON THE INTRODUCTION OF A HOSTILE ENTITY! THUS, WE HAVE PROVIDED AN ENEMY FOR YOU TO DEFEAT IN THIS ROOM. PRESS THE BUTTON WHEN YOU FEEL YOU ARE READY TO FIGHT IT!

This is another large, barren concrete room. Exits are to the north and south.

There is a hostile entity trapped by a force field on the other half of the room from you.

The entity grins at you. Well, not so much "grin" as "curl back its lips and roll its eyes back into its head."

>throw mend at entity
You throw the MEND alloy at the hostile entity. Bonk! The MEND alloy lands on the floor.

GOOD THROWING ARM! I DON'T HAVE ARMS, SO THAT'S ESPECIALLY IMPRESSIVE.

The entity ripples, as if a giant worm is crawling around just under the surface of its skin.

[Your score has just gone up by five points.]

>press button
Suddenly, blue waves ripple across the air in the center of the room, revealing the barrier. It dissolves with a final shimmer.

The entity makes a guttural clicking sound and scuttles across the floor towards you!

The entity attacks you, causing 20 points of damage!

>x shield
You can't see any such thing.

>n
Combination Station

You are standing in another concrete room. There are exits to the North and South. In the center is a vast machine labeled 'Combinator'. The machine has 3 slots to put alloys in:

Slot 1 is empty.

Slot 2 is empty.

Slot 3 is empty.

You can also see a green button labelled GO and Intern Jim here.

>n
Supply Room
You are standing in a spacious room made of reinforced concrete. A lighting panel illuminates the room in a tense white glow. There is another room to the south.

An alcove is carved into the wall in front of you. Hovering in the alcove are a SHIELD alloy, a BLADE alloy, an ENTROPIC alloy and a SPARK alloy.

A large red button labeled RESUPPLY is mounted above the alcove.

>x shield
A fist-sized cube of pure SHIELD alloy is hovering in front of you. It seems eager to morph into something useful.

I ADMIRE YOUR INQUISITIVE NATURE!

[Your score has just gone up by five points.]

>x lighting
A flat white panel is embedded in the concrete on the ceiling. It glows with a uniform brightness.

I ADMIRE YOUR EXPLORATORY NATURE!

[Your score has just gone up by five points.]

>attack lighting
You've always fantasized about fighting a light. But it doesn't feel right, because fighting the light might leave you in night.

>throw shield at light
(first taking the SHIELD alloy)
The lighting panel is unfazed by your attempts to bring it off its high horse.

HUMAN, WHAT DID THAT LIGHT EVER DO TO YOU?

You throw the SHIELD alloy at the lighting panel. Bonk! The SHIELD alloy lands on the floor.

NICE THROWING!

[Your score has just gone up by five points.]

>taste light
You can't reach the panel from down here. Instead, you close your eyes and imagine a warm sunrise basking over your tongue.

EXCELLENT! BE SURE TO INSPECT YOUR ENVIRONMENT CAREFULLY!

[Your score has just gone up by five points.]

>taste wall
You lick the concrete. You think someone once told you this is how you get "stoned."

AMAZING! YOUR TASTING ABILITIES ARE UNPARALLELED.

[Your score has just gone up by five points.]

>taste blae
You can't see any such thing.

>eat blade
You gingerly move to lick the BLADE alloy. Ow! It smacks your face with its flat side.

NICE! TASTING THAT BLADE alloy GAVE ME A VICARIOUS THRILL!

[Your score has just gone up by five points.]

>smell blae
You can't see any such thing.

>smell blade
You smell the BLADE alloy. It has a sharp, metallic scent, not unlike blood.

EXCELLENT! BE SURE TO INSPECT YOUR ENVIRONMENT CAREFULLY!

[Your score has just gone up by five points.]

>smell entropic
The caustic alloy burns the inside of your nose. Your eyes water.

AMAZING! YOUR SNIFFING ABILITIES ARE UNPARALLELED.

[Your score has just gone up by five points.]

>taste entropy
You can't see any such thing.

>taste entropic
You put your lips on the ENTROPIC alloy. Suddenly, it tries to absorb your face! The caustic darkness burns where it touches on your face, and you quickly fling it away.

AMAZING! YOUR TASTING ABILITIES ARE UNPARALLELED.

[Your score has just gone up by five points.]

>eat  mend
You can't see any such thing.

>eat mend
You can't see any such thing.

>press resupply
You press the button, with a satisfying "click."
A MEND alloy teleports in!

>eat mend
You put the MEND alloy in your mouth. Mmmm, tastes like buttercream. You take it out of your mouth out of respect.

EXCELLENT! BE SURE TO INSPECT YOUR ENVIRONMENT CAREFULLY!

[Your score has just gone up by five points.]

>smell mend
The soothing scent of lavender washes over you. You close your eyes and enjoy it for a moment.

NICE! SMELLING THAT MEND alloy GAVE ME A VICARIOUS THRILL!

[Your score has just gone up by five points.]

>touch mend
EXCELLENT! BE SURE TO INSPECT YOUR ENVIRONMENT CAREFULLY!

[Your score has just gone up by five points.]

>look
Supply Room
You are standing in a spacious room made of reinforced concrete. A lighting panel illuminates the room in a tense white glow. There is another room to the south.

An alcove is carved into the wall in front of you. Hovering in the alcove are a MEND alloy, a BLADE alloy, an ENTROPIC alloy and a SPARK alloy.

A large red button labeled RESUPPLY is mounted above the alcove.

>touch button
You softly brush your finger against the button, instead of pushing it. What a tease!

AMAZING! YOUR TACTILE ABILITIES ARE UNPARALLELED.

[Your score has just gone up by five points.]

>smell button
HOW VERY BLOODHOUND OF YOU!

[Your score has just gone up by five points.]

>push button
You press the button, with a satisfying "click."

*BZZZZZ* ALL THE ALLOYS ARE ALREADY IN THIS ROOM. IF YOU USE ONE UP YOU CAN BRING IT BACK WITH THIS BUTTON!

>s
Combination Station

You are standing in another concrete room. There are exits to the North and South. In the center is a vast machine labeled 'Combinator'. The machine has 3 slots to put alloys in:

Slot 1 is empty.

Slot 2 is empty.

Slot 3 is empty.

You can also see a green button labelled GO and Intern Jim here.

>push button
There are 3 slots that don't have an alloy in them! Please put another alloy in before you press GO.

>ask jim about machine
"This room houses the Combinator! Truly the greatest invention in this simulation. It takes in whatever 3 alloys you stick in it and spits out an amazing creation that takes on all 3 of their aspects! Try it out by taking 3 alloys from the Supply Room and using the command COMBINE."

>n
Supply Room
You are standing in a spacious room made of reinforced concrete. A lighting panel illuminates the room in a tense white glow. There is another room to the south.

An alcove is carved into the wall in front of you. Hovering in the alcove are a MEND alloy, a BLADE alloy, an ENTROPIC alloy and a SPARK alloy.

A large red button labeled RESUPPLY is mounted above the alcove.

>take mend, shield and spark
MEND alloy: Taken.
SHIELD alloy: Taken.
SPARK alloy: Taken.

>combine
Combination Station

You are standing in another concrete room. There are exits to the North and South. In the center is a vast machine labeled 'Combinator'. The machine has 3 slots to put alloys in:

Slot 1 is empty.

Slot 2 is empty.

Slot 3 is empty.

You can also see a green button labelled GO and Intern Jim here.

You walk to the Combination Station.

You put the SHIELD alloy into slot 1.

Slot 1 is full, so let's put MEND alloy in slot 2. You put the MEND alloy into slot 2.

Slot 1 is full, so let's put SPARK alloy in slot 2. Slot 2 is full, so let's put SPARK alloy in slot 3. You put the SPARK alloy into slot 3.

Ingredient list: MEND alloy, SHIELD alloy and SPARK alloy

The SHIELD and MELD alloys combine to form a magical helmet, and the SPARK alloy makes itself busy by creating a system that diagnoses and heals your wounds. Neat!

AMAZING! THAT'S AN INCREDIBLE HEALING HELMET YOU'VE JUST CREATED! I'M AWARDING YOU 20 CREATIVITY POINTS FOR IT.

You now carry a brand-new healing helmet.

[Your score has just gone up by twenty points.]

>wear healing helmet
You place the helmet on your head. Your body surges with healing energy! You'll heal a little each turn.

mmm.

* * *

>s
Combination Station
WELCOME TO THE QUALIFICATION DETERMINATION SIMULATION COMBINATION STATION! HERE YOU CAN TAKE ALLOYS FROM THE PREVIOUS ROOM AND FORM THEM INTO NEW AND FANCIFUL CREATIONS. WHAT ARE YOU WAITING FOR? LET'S GET CREATIVE!

You are standing in another concrete room. There are exits to the North and South. In the center is a vast machine labeled 'Combinator'. The machine has 3 slots to put alloys in:

Slot 1 is empty.

Slot 2 is empty.

Slot 3 is empty.

You can also see a green button labelled GO and Intern Jim here.

>throw mend at slot
Which do you mean, slot 1, slot 2 or slot 3?

>throw mend at slot 1
Futile.

* * *

>s
Combination Station
WELCOME TO THE QUALIFICATION DETERMINATION SIMULATION COMBINATION STATION! HERE YOU CAN TAKE ALLOYS FROM THE PREVIOUS ROOM AND FORM THEM INTO NEW AND FANCIFUL CREATIONS. WHAT ARE YOU WAITING FOR? LET'S GET CREATIVE!

You are standing in another concrete room. There are exits to the North and South. In the center is a vast machine labeled 'Combinator'. The machine has 3 slots to put alloys in:

Slot 1 is empty.

Slot 2 is empty.

Slot 3 is empty.

You can also see a green button labelled GO and Intern Jim here.

>throw mend at slot 1
Nice shot!

>rules all
Rules tracing now switched to "all". Type "rules off" to switch it off again.

>throw mend at slot 1
[Rule "debounce arrange event rule" does not apply (wrong action).]
[Rule "redirect to GEP timed activity rule" does not apply (wrong action).]
[Rule "redirect to GEP character input rule" does not apply (wrong action).]
[Rule "redirect to GEP line input rule" applies.]
[Rule "redirect to GEP mouse input rule" does not apply (wrong action).]
[Rule "redirect to GEP arranging rule" does not apply (wrong action).]
[Rule "redirect to GEP redrawing rule" does not apply (wrong action).]
[Rule "redirect to GEP sound notification rule" does not apply (wrong action).]
[Rule "redirect to GEP hyperlink rule" does not apply (wrong action).]
[Rule "ordinary checking for content rule" applies.]
[Rule "declare everything initially unmentioned rule" applies.]
[Rule "announce items from multiple object lists rule" applies.]
[Rule "set pronouns from items from multiple object lists rule" applies.]
[Rule "before stage rule" applies.]
[Rule "don't ignore the rating module rule" applies.]
[Rule "instead stage rule" applies.]
[Rule "investigate player's awareness before action rule" applies.]
[Rule "player aware of his own actions rule" applies.]
[Rule "check stage rule" applies.]
[Rule "implicitly remove thrown clothing rule" applies.]
[Rule "futile to throw things at inanimate objects rule" applies.]
Futile.

[Rule "A first turn sequence rule" applies.]
[Rule "every turn stage rule" applies.]
[Rule "first rating happens" applies.]
HELLO AGAIN! I'D LIKE TO INTRODUCE... THE RATINGS MODULE! HUMAN FEEDBACK IS CRUCIAL TO CREATIVITRIX, AND THIS LITTLE GUY IS HERE TO COLLECT IT! I'LL LET HIM TALK:

 Please rate your experience with the CREATIVITRIX QUALIFICATION DETERMINATION SIMULATION thus far:

5 - Excellent

4 - Appealing

3 - Unremarkable

2 - Lackluster

1 - Truly Awful

[Rule "A last turn sequence rule" applies.]
[Rule "notify score changes rule" applies.]

* * *

>take mend
Taken.

>throw mend at button
You throw the MEND alloy at the large red button labeled RESUPPLY. Bonk! The MEND alloy lands on the floor.

Nice shot! The MEND alloy pushes the button for you! Now THAT'S convenience.

You press the button, with a satisfying "click."

*BZZZZZ* ALL THE ALLOYS ARE ALREADY IN THIS ROOM. IF YOU USE ONE UP YOU CAN BRING IT BACK WITH THIS BUTTON!

>s
Combination Station
WELCOME TO THE QUALIFICATION DETERMINATION SIMULATION COMBINATION STATION! HERE YOU CAN TAKE ELEMENTS FROM THE PREVIOUS ROOM AND FORM THEM INTO NEW AND FANCIFUL CREATIONS. WHAT ARE YOU WAITING FOR? LET'S GET CREATIVE!

You are standing in another concrete room. There are exits to the North and South. In the center is a vast machine labeled 'Combinator'. The machine has 3 slots to put elements in:

Slot 1 is empty.

Slot 2 is empty.

Slot 3 is empty.

You can also see a green button labelled GO and Intern Jymm here.

>throw mend at slot 1
You lack the nerve when it comes to the crucial moment.

HELLO AGAIN! I'D LIKE TO INTRODUCE... THE RATINGS MODULE! HUMAN FEEDBACK IS CRUCIAL TO CREATIVITRIX, AND THIS LITTLE GUY IS HERE TO COLLECT IT! I'LL LET HIM TALK:

 Please rate your experience with the CREATIVITRIX QUALIFICATION DETERMINATION SIMULATION thus far:

5 - Excellent

4 - Appealing

3 - Unremarkable

2 - Lackluster

1 - Truly Awful

>a
That's not a verb I recognise.

>jump
rate 3 stars
THANK YOU FOR YOUR FEEDBACK!

>rules all
Rules tracing now switched to "all". Type "rules off" to switch it off again.

>throw mend at slot 1
[Rule "debounce arrange event rule" does not apply (wrong action).]
[Rule "redirect to GEP timed activity rule" does not apply (wrong action).]
[Rule "redirect to GEP character input rule" does not apply (wrong action).]
[Rule "redirect to GEP line input rule" applies.]
[Rule "redirect to GEP mouse input rule" does not apply (wrong action).]
[Rule "redirect to GEP arranging rule" does not apply (wrong action).]
[Rule "redirect to GEP redrawing rule" does not apply (wrong action).]
[Rule "redirect to GEP sound notification rule" does not apply (wrong action).]
[Rule "redirect to GEP hyperlink rule" does not apply (wrong action).]
[Rule "ordinary checking for content rule" applies.]
[Rule "declare everything initially unmentioned rule" applies.]
[Rule "announce items from multiple object lists rule" applies.]
[Rule "set pronouns from items from multiple object lists rule" applies.]
[Rule "before stage rule" applies.]
[Rule "don't ignore the rating module rule" applies.]
[Rule "instead stage rule" applies.]
[Rule "investigate player's awareness before action rule" applies.]
[Rule "player aware of his own actions rule" applies.]
[Rule "check stage rule" applies.]
[Rule "implicitly remove thrown clothing rule" applies.]
[Rule "block throwing at rule" applies.]
You lack the nerve when it comes to the crucial moment.

[Rule "A first turn sequence rule" applies.]
[Rule "every turn stage rule" applies.]
[Rule "A last turn sequence rule" applies.]
[Rule "notify score changes rule" applies.]

* * *

>take mend
Taken.

>throw mend at light
You throw the MEND alloy at the lighting panel. Bonk! The MEND alloy lands on the floor.

>look
Supply Room
You are standing in a spacious room made of reinforced concrete. A lighting panel illuminates the room in a tense white glow. There is another room to the south.

An alcove is carved into the wall in front of you. Hovering in the alcove are a SHIELD alloy, a BLADE alloy, an ENTROPIC alloy and a SPARK alloy.

A large red button labeled RESUPPLY is mounted above the alcove.

You can also see a MEND alloy here.

>take mend
Taken.

HELLO AGAIN! I'D LIKE TO INTRODUCE... THE RATINGS MODULE! HUMAN FEEDBACK IS CRUCIAL TO CREATIVITRIX, AND THIS LITTLE GUY IS HERE TO COLLECT IT! I'LL LET HIM TALK:

 Please rate your experience with the CREATIVITRIX QUALIFICATION DETERMINATION SIMULATION thus far:

5 - Excellent

4 - Appealing

3 - Unremarkable

2 - Lackluster

1 - Truly Awful

>s
YOU'VE GOT TO ANSWER THE RATING MODULE'S QUESTION FIRST! LOOK AT THE POOR LITTLE GUY, ALL HE WANTS TO DO IS HELP!

>rate 5 stars
THANK YOU FOR YOUR FEEDBACK!

>s
Combination Station
WELCOME TO THE QUALIFICATION DETERMINATION SIMULATION COMBINATION STATION! HERE YOU CAN TAKE ELEMENTS FROM THE PREVIOUS ROOM AND FORM THEM INTO NEW AND FANCIFUL CREATIONS. WHAT ARE YOU WAITING FOR? LET'S GET CREATIVE!

You are standing in another concrete room. There are exits to the North and South. In the center is a vast machine labeled 'Combinator'. The machine has 3 slots to put elements in:

Slot 1 is empty.

Slot 2 is empty.

Slot 3 is empty.

You can also see a green button labelled GO and Intern Jymm here.

>throw mend at slot 1
Nice shot!

You put the MEND alloy into slot 1.

>throw mend at slot 1
(first taking the MEND alloy)
Nice shot!

You put the MEND alloy into slot 1.

>throw mend at machine
(first taking the MEND alloy)
You throw the MEND alloy at the vast machine labeled 'Combinator'

* * *

>throw mend at light
You throw the MEND alloy at the lighting panel. Bonk! The MEND alloy lands on the floor.

>rules all
Rules tracing now switched to "all". Type "rules off" to switch it off again.

* * *

 

 

Supply Room
You are standing in a spacious room made of reinforced concrete. A lighting panel illuminates the room in a tense white glow. There is another room to the SOUTH.

An alcove is carved into the wall in front of you. Hovering in the alcove are a SHIELD alloy, a BLADE alloy, an ENTROPIC alloy, a MEND alloy and a SPARK alloy.

A large red button labeled RESUPPLY is mounted above the alcove.

>take mend and spark
MEND alloy: Test this
Taken.
SPARK alloy: Test 
Taken.

* * *

>take shield
Test 
Taken.

>combine
rate 5 stars
THANK YOU FOR YOUR FEEDBACK!

>press go
Ingedients: SHIELD alloy

* * *

>take mend and spark
MEND alloy: Test this
Taken.
SPARK alloy: Test 
Taken.

>s
Combination Station
WELCOME TO THE QUALIFICATION DETERMINATION SIMULATION COMBINATION STATION! HERE YOU CAN TAKE ELEMENTS FROM THE PREVIOUS ROOM AND FORM THEM INTO NEW AND FANCIFUL CREATIONS. WHAT ARE YOU WAITING FOR? LET'S GET CREATIVE!

You are standing in another concrete room. There are exits to the North and South. In the center is a vast machine labeled 'Combinator'. The machine has 3 slots to put elements in:

Slot 1 is empty.

Slot 2 is empty.

Slot 3 is empty.

You can also see a green button labelled GO here.

>put all in 1
SPARK alloy: Done.
MEND alloy: Done.

>look
Combination Station

You are standing in another concrete room. There are exits to the North and South. In the center is a vast machine labeled 'Combinator'. The machine has 3 slots to put elements in:

Slot 1 contains a SPARK alloy.

Slot 2 contains a MEND alloy.

>take mend and spark
MEND alloy: Test 
Taken.
SPARK alloy: Test 
Taken.

>put all in slot
Which do you mean, slot 1 or slot 2?

* * *

>s
Combination Station
WELCOME TO THE QUALIFICATION DETERMINATION SIMULATION COMBINATION STATION! HERE YOU CAN TAKE ELEMENTS FROM THE PREVIOUS ROOM AND FORM THEM INTO NEW AND FANCIFUL CREATIONS. WHAT ARE YOU WAITING FOR? LET'S GET CREATIVE!

You are standing in another concrete room. There are exits to the North and South. In the center is a vast machine labeled 'Combinator'. The machine has 3 slots to put elements in:

Slot 1 is empty.

Slot 2 is empty.

Slot 3 is empty.

You can also see a green button labelled GO here.

>put all in slot
(slot 1)
SPARK alloy: Slot 1 is full, so let's put SPARK alloy in slot 2.

Done.
MEND alloy: Done.

>look
Combination Station

You are standing in another concrete room. There are exits to the North and South. In the center is a vast machine labeled 'Combinator'. The machine has 3 slots to put elements in:

Slot 1 is empty.

Slot 2 is empty.

>inv
You are carrying nothing.

* * *

>s
Combination Station
WELCOME TO THE QUALIFICATION DETERMINATION SIMULATION COMBINATION STATION! HERE YOU CAN TAKE ELEMENTS FROM THE PREVIOUS ROOM AND FORM THEM INTO NEW AND FANCIFUL CREATIONS. WHAT ARE YOU WAITING FOR? LET'S GET CREATIVE!

You are standing in another concrete room. There are exits to the North and South. In the center is a vast machine labeled 'Combinator'. The machine has 3 slots to put elements in:

Slot 1 is empty.

Slot 2 is empty.

Slot 3 is empty.

You can also see a green button labelled GO here.

>put mend and spark in slot
(slot 1)
MEND alloy: Done.
SPARK alloy: Slot 1 is full, so let's put SPARK alloy in slot 2. Done.

>look
Combination Station

You are standing in another concrete room. There are exits to the North and South. In the center is a vast machine labeled 'Combinator'. The machine has 3 slots to put elements in:

Slot 1 is empty.

Slot 2 is empty.

* * *

>put mend and spark in slot
(slot 1)
MEND alloy: Done.
SPARK alloy: Slot 1 is full, so let's put SPARK alloy in slot 2. Done.

>n
Supply Room
You are standing in a spacious room made of reinforced concrete. A lighting panel illuminates the room in a tense white glow. There is another room to the south.

An alcove is carved into the wall in front of you. Hovering in the alcove are a SHIELD alloy, a BLADE alloy and an ENTROPIC alloy.

A large red button labeled RESUPPLY is mounted above the alcove.

>combine
There's 3 free slots and you are only carrying 0 alloys. Go take another and try again!

* * *

>put mend and spark in slot
(slot 1)
MEND alloy: Done.
SPARK alloy: Slot 1 is full, so let's put SPARK alloy in slot 2. Done.

>z
Time passes.

HELLO AGAIN! I'D LIKE TO INTRODUCE... THE RATINGS MODULE! HUMAN FEEDBACK IS CRUCIAL TO CREATIVITRIX, AND THIS LITTLE GUY IS HERE TO COLLECT IT! I'LL LET HIM TALK:

 Please rate your experience with the CREATIVITRIX QUALIFICATION DETERMINATION SIMULATION thus far:

5 - Excellent

4 - Appealing

3 - Unremarkable

2 - Lackluster

1 - Truly Awful

>rate 1 stars
THANK YOU FOR YOUR FEEDBACK!

>look
Combination Station

You are standing in another concrete room. There are exits to the North and South. In the center is a vast machine labeled 'Combinator'. The machine has 3 slots to put elements in:

Slot 1 contains a MEND alloy.

Slot 2 contains a SPARK alloy.

Slot 3 is empty.

You can also see a green button labelled GO here.

>press go
INgredients: MEND alloy and SPARK alloy

>take spark
Test 
Taken.

>take mend
Test 
Taken.

>put spark in slot 1
You put the SPARK alloy into slot 1.

>put mend in slot 1
Slot 1 is full, so let's put MEND alloy in slot 2. You put the MEND alloy into slot 2.

>press go
INgredients: MEND alloy and SPARK alloy

>look
Combination Station

You are standing in another concrete room. There are exits to the North and South. In the center is a vast machine labeled 'Combinator'. The machine has 3 slots to put elements in:

Slot 1 contains a SPARK alloy.

Slot 2 contains a MEND alloy.

Slot 3 is empty.

You can also see a green button labelled GO here.

>n
Supply Room
You are standing in a spacious room made of reinforced concrete. A lighting panel illuminates the room in a tense white glow. There is another room to the south.

An alcove is carved into the wall in front of you. Hovering in the alcove are a SHIELD alloy, a BLADE alloy and an ENTROPIC alloy.

A large red button labeled RESUPPLY is mounted above the alcove.

>take blade
Test 
Taken.

>s
Combination Station

You are standing in another concrete room. There are exits to the North and South. In the center is a vast machine labeled 'Combinator'. The machine has 3 slots to put elements in:

Slot 1 contains a SPARK alloy.

Slot 2 contains a MEND alloy.

Slot 3 is empty.

You can also see a green button labelled GO here.

>put blade in slot
(slot 1)
Slot 1 is full, so let's put BLADE alloy in slot 2. Slot 2 is full, so let's put BLADE alloy in slot 3. You put the BLADE alloy into slot 3.

>press go
INgredients: BLADE alloy, MEND alloy and SPARK alloy

* * *

>s
Combination Station
WELCOME TO THE QUALIFICATION DETERMINATION SIMULATION COMBINATION STATION! HERE YOU CAN TAKE ELEMENTS FROM THE PREVIOUS ROOM AND FORM THEM INTO NEW AND FANCIFUL CREATIONS. WHAT ARE YOU WAITING FOR? LET'S GET CREATIVE!

You are standing in another concrete room. There are exits to the North and South. In the center is a vast machine labeled 'Combinator'. The machine has 3 slots to put elements in:

Slot 1 is empty.

Slot 2 is empty.

Slot 3 is empty.

You can also see a green button labelled GO here.

>put mend in 1
You put the MEND alloy into slot 1.

>put spark in 1
There is no more room in slot 1.

>look
Combination Station

You are standing in another concrete room. There are exits to the North and South. In the center is a vast machine labeled 'Combinator'. The machine has 3 slots to put elements in:

Slot 1 contains a MEND alloy.

>x 1
HI MOM
In slot 1 is a MEND alloy.

* * *

>s
Combination Station
WELCOME TO THE QUALIFICATION DETERMINATION SIMULATION COMBINATION STATION! HERE YOU CAN TAKE ELEMENTS FROM THE PREVIOUS ROOM AND FORM THEM INTO NEW AND FANCIFUL CREATIONS. WHAT ARE YOU WAITING FOR? LET'S GET CREATIVE!

You are standing in another concrete room. There are exits to the North and South. In the center is a vast machine labeled 'Combinator'. The machine has 3 slots to put elements in:

Slot 1 is empty.

Slot 2 is empty.

Slot 3 is empty.

You can also see a green button labelled GO here.

>put mend in slot
You put the MEND alloy into slot 1.

>put spark in slot
That slot already has nothing in it.

>take mend
Test 
Taken.

>inv
You are carrying:
  a MEND alloy
  a SPARK alloy

>put spark in slot
You put the SPARK alloy into slot 1.

* * *

>s
Combination Station
WELCOME TO THE QUALIFICATION DETERMINATION SIMULATION COMBINATION STATION! HERE YOU CAN TAKE ELEMENTS FROM THE PREVIOUS ROOM AND FORM THEM INTO NEW AND FANCIFUL CREATIONS. WHAT ARE YOU WAITING FOR? LET'S GET CREATIVE!

You are standing in another concrete room. There are exits to the North and South. In the center is a vast machine labeled 'Combinator'. The machine has 3 slots to put elements in:

Slot 1 is empty.

Slot 2 is empty.

Slot 3 is empty.

You can also see a green button labelled GO here.

>put mend in slot 1
You put the MEND alloy into slot 1.

>look
Combination Station

You are standing in another concrete room. There are exits to the North and South. In the center is a vast machine labeled 'Combinator'. The machine has 3 slots to put elements in:

Slot 1 is empty.

>put spark in slot 1
You put the SPARK alloy into slot 1.

>x plaque
A small plaque attached to the side of the machine. It says "Combinator" in a pleasing Arial font.

>x sign
A small plaque attached to the side of the machine. It says "Combinator" in a pleasing Arial font.

* * *

>put mend in slot 1
You put the MEND alloy into slot 1.

>put spark in slot 1
You put the SPARK alloy into slot 1.

* * *

>s
Combination Station
WELCOME TO THE QUALIFICATION DETERMINATION SIMULATION COMBINATION STATION! HERE YOU CAN TAKE ELEMENTS FROM THE PREVIOUS ROOM AND FORM THEM INTO NEW AND FANCIFUL CREATIONS. WHAT ARE YOU WAITING FOR? LET'S GET CREATIVE!

You are standing in another concrete room. There are exits to the North and South. In the center is a vast machine labeled 'Combinator'. The machine has 3 slots to put elements in:

Slot 1 is empty.

Slot 2 is empty.

Slot 3 is empty.

You can also see a green button labelled GO here.

>put mend into 1
You put the MEND alloy into slot 1.

>put spark into 1
You put the SPARK alloy into slot 2.

* * *

>s
Combination Station
WELCOME TO THE QUALIFICATION DETERMINATION SIMULATION COMBINATION STATION! HERE YOU CAN TAKE ELEMENTS FROM THE PREVIOUS ROOM AND FORM THEM INTO NEW AND FANCIFUL CREATIONS. WHAT ARE YOU WAITING FOR? LET'S GET CREATIVE!

You are standing in another concrete room. There are exits to the North and South. In the center is a vast machine labeled 'Combinator'. The machine has 3 slots to put elements in:

Slot 1 is empty.

Slot 2 is empty.

Slot 3 is empty.

You can also see a green button labelled GO here.

>put mend into slot
(slot 1)
You put the MEND alloy into slot 2.

>put mend into slot
(slot 1)
(first taking the MEND alloy)
You put the MEND alloy into slot 2.

>put spark into 1
There is no more room in slot 2.

>put spark into 1
There is no more room in slot 2.

>lok
That's not a verb I recognise.

>look
Combination Station

You are standing in another concrete room. There are exits to the North and South. In the center is a vast machine labeled 'Combinator'. The machine has 3 slots to put elements in:

Slot 1 contains nothing.

Slot 2 contains a MEND alloy.

>inv
You are carrying:
  a SPARK alloy

>abstract slot 1 to me
[Abstracted.]

>look
Combination Station

You are standing in another concrete room. There are exits to the North and South. In the center is a vast machine labeled 'Combinator'. The machine has 3 slots to put elements in:

Slot 2 contains a MEND alloy.

>inv
You are carrying:
  slot 1
  a SPARK alloy

>drop slot 1
Dropped.

>look
Combination Station

You are standing in another concrete room. There are exits to the North and South. In the center is a vast machine labeled 'Combinator'. The machine has 3 slots to put elements in:

Slot 2 contains a MEND alloy.

You can also see slot 1 (empty) here.

>put spark into 1
There is no more room in slot 2.

* * *

>put mend into slot
(slot 1)
You put the MEND alloy into slot 2.

>put spark into slot
You put the SPARK alloy into slot 1.

>take mend and spark
MEND alloy: Test 
Taken.
SPARK alloy: Test 
Taken.

>put spark and mend into slot
SPARK alloy: Done.
MEND alloy: Done.

>take spark and mend
SPARK alloy: Test 
Taken.
MEND alloy: Test 
Taken.

>actions
Actions listing on.

* * *

>rules
Rules tracing now switched on. Type "rules off" to switch it off again, or "rules all" to include even rules which do not apply.

>put spark into slot
[Rule "redirect to GEP line input rule" applies.]
[Rule "ordinary checking for content rule" applies.]
[Rule "declare everything initially unmentioned rule" applies.]
[inserting the SPARK alloy into slot 1]
[Rule "announce items from multiple object lists rule" applies.]
[Rule "set pronouns from items from multiple object lists rule" applies.]
[Rule "before stage rule" applies.]
[Rule "instead stage rule" applies.]
[Rule "investigate player's awareness before action rule" applies.]
[Rule "player aware of his own actions rule" applies.]
[Rule "check stage rule" applies.]
[Rule "Check inserting something into a slot" applies.]
[Rule "convert insert to drop where possible rule" applies.]
[Rule "can't insert what's not held rule" applies.]
[Rule "can't insert something into itself rule" applies.]
[Rule "can't insert into closed containers rule" applies.]
[Rule "can't insert into what's not a container rule" applies.]
[Rule "can't insert clothes being worn rule" applies.]
[Rule "can't insert if this exceeds carrying capacity rule" applies.]
[Rule "carry out stage rule" applies.]
[Rule "standard inserting rule" applies.]
[Rule "after stage rule" applies.]
[Rule "investigate player's awareness after action rule" applies.]
[Rule "report stage rule" applies.]
[Rule "concise report inserting rule" applies.]
[Rule "standard report inserting rule" applies.]
You put the SPARK alloy into slot 1.
[Rule "last specific action-processing rule" applies.]
[inserting the SPARK alloy into slot 1 - succeeded]

[Rule "A first turn sequence rule" applies.]
[Rule "every turn stage rule" applies.]
[Rule "A last turn sequence rule" applies.]
[Rule "notify score changes rule" applies.]

* * *

>put mend into slot
(slot 1)
You put the MEND alloy into slot 2.

>put spark into slot 1
You put the SPARK alloy into slot 1.

* * *

 

 

Supply Room
You are standing in a spacious room made of reinforced concrete. A lighting panel illuminates the room in a tense white glow. There is another room to the SOUTH.

An alcove is carved into the wall in front of you. Hovering in the alcove are a SHIELD alloy, a BLADE alloy, an ENTROPIC alloy, a MEND alloy and a SPARK alloy.

A large red button labeled RESUPPLY is mounted above the alcove.

>take mend spark and shield
I only understood you as far as wanting to take the MEND alloy.

* * *

>take mend, spark and shield
MEND alloy: Test this
Taken.
SPARK alloy: Test 
Taken.
SHIELD alloy: Test 
Taken.

>combine
Combination Station
WELCOME TO THE QUALIFICATION DETERMINATION SIMULATION COMBINATION STATION! HERE YOU CAN TAKE ELEMENTS FROM THE PREVIOUS ROOM AND FORM THEM INTO NEW AND FANCIFUL CREATIONS. WHAT ARE YOU WAITING FOR? LET'S GET CREATIVE!

You are standing in another concrete room. There are exits to the North and South. In the center is a vast machine labeled 'Combinator'. The machine has 3 slots to put elements in:

Slot 1 contains nothing.

Slot 2 contains nothing.

Slot 3 contains nothing.

You put the SHIELD alloy into slot 1.

Slot 1 is full, so let's put MEND alloy in slot 2.You put the MEND alloy into slot 2.

Slot 1 is full, so let's put SPARK alloy in slot 2.There is no more room in slot 2.

* * *

 

 

Supply Room
You are standing in a spacious room made of reinforced concrete. A lighting panel illuminates the room in a tense white glow. There is another room to the SOUTH.

An alcove is carved into the wall in front of you. Hovering in the alcove are a SHIELD alloy, a BLADE alloy, an ENTROPIC alloy, a MEND alloy and a SPARK alloy.

A large red button labeled RESUPPLY is mounted above the alcove.

>take mend, blade and shield
MEND alloy: Test this
Taken.
BLADE alloy: Test 
Taken.
SHIELD alloy: Test 
Taken.

>combine
Combination Station
WELCOME TO THE QUALIFICATION DETERMINATION SIMULATION COMBINATION STATION! HERE YOU CAN TAKE ELEMENTS FROM THE PREVIOUS ROOM AND FORM THEM INTO NEW AND FANCIFUL CREATIONS. WHAT ARE YOU WAITING FOR? LET'S GET CREATIVE!

You are standing in another concrete room. There are exits to the North and South. In the center is a vast machine labeled 'Combinator'. The machine has 3 slots to put elements in:

Slot 1 is empty.

Slot 2 is empty.

Slot 3 is empty.

You can also see a green button labelled GO here.

You put the SHIELD alloy into slot 1.

Slot 1 is full, so let's put BLADE alloy in slot 2. You put the BLADE alloy into slot 2.

Slot 1 is full, so let's put MEND alloy in slot 2. Slot 2 is full, so let's put MEND alloy in slot 3. You put the MEND alloy into slot 3.

>press go
Ingredient list: BLADE alloy, MEND alloy and SHIELD alloy

The BLADE alloy warps itself into a long syringe, and the MEND alloy fills it with a healing light! The SHIELD alloy reinforces the syringe and gives the chemical inside a fortifying property.

* * *

 

 

Supply Room
You are standing in a spacious room made of reinforced concrete. A lighting panel illuminates the room in a tense white glow. There is another room to the SOUTH.

An alcove is carved into the wall in front of you. Hovering in the alcove are a SHIELD alloy, a BLADE alloy, an ENTROPIC alloy, a MEND alloy and a SPARK alloy.

A large red button labeled RESUPPLY is mounted above the alcove.

>take mend, shield and blade
MEND alloy: Test this
Taken.
SHIELD alloy: Test 
Taken.
BLADE alloy: Test 
Taken.

>combine
Combination Station
WELCOME TO THE QUALIFICATION DETERMINATION SIMULATION COMBINATION STATION! HERE YOU CAN TAKE ELEMENTS FROM THE PREVIOUS ROOM AND FORM THEM INTO NEW AND FANCIFUL CREATIONS. WHAT ARE YOU WAITING FOR? LET'S GET CREATIVE!

You are standing in another concrete room. There are exits to the North and South. In the center is a vast machine labeled 'Combinator'. The machine has 3 slots to put elements in:

Slot 1 is empty.

Slot 2 is empty.

Slot 3 is empty.

You can also see a green button labelled GO here.

You put the SHIELD alloy into slot 1.

Slot 1 is full, so let's put BLADE alloy in slot 2. You put the BLADE alloy into slot 2.

Slot 1 is full, so let's put MEND alloy in slot 2. Slot 2 is full, so let's put MEND alloy in slot 3. You put the MEND alloy into slot 3.

* * *

>press go
Ingredient list: BLADE alloy, MEND alloy and SHIELD alloyThe BLADE alloy warps itself into a long syringe, and the MEND alloy fills it with a healing light! The SHIELD alloy reinforces the syringe and gives the chemical inside a fortifying property.

>inv
rate 5 stars
THANK YOU FOR YOUR FEEDBACK!

>x healing syringe
You see nothing special about the healing syringe.

I ADMIRE YOUR INQUISITIVE NATURE!
THE RATING MODULE IS BACK WITH ANOTHER MESSAGE! ISN'T HE CUTE?

 Please rate the description of the healing syringe:

5 - Life changing

4 - Impressive

3 - Mediocre

2 - Trivial

1 - Disgusting

[Your score has just gone up by five points.]

* * *

 

 

Supply Room
You are standing in a spacious room made of reinforced concrete. A lighting panel illuminates the room in a tense white glow. There is another room to the SOUTH.

An alcove is carved into the wall in front of you. Hovering in the alcove are a SHIELD alloy, a BLADE alloy, an ENTROPIC alloy, a MEND alloy and a SPARK alloy.

A large red button labeled RESUPPLY is mounted above the alcove.

>take mend, shield and spark
MEND alloy: Test this
Taken.
SHIELD alloy: Test 
Taken.
SPARK alloy: Test 
Taken.

>combine
Combination Station
WELCOME TO THE QUALIFICATION DETERMINATION SIMULATION COMBINATION STATION! HERE YOU CAN TAKE ELEMENTS FROM THE PREVIOUS ROOM AND FORM THEM INTO NEW AND FANCIFUL CREATIONS. WHAT ARE YOU WAITING FOR? LET'S GET CREATIVE!

You are standing in another concrete room. There are exits to the North and South. In the center is a vast machine labeled 'Combinator'. The machine has 3 slots to put elements in:

Slot 1 is empty.

Slot 2 is empty.

Slot 3 is empty.

You can also see a green button labelled GO here.

You put the SHIELD alloy into slot 1.

Slot 1 is full, so let's put MEND alloy in slot 2. You put the MEND alloy into slot 2.

Slot 1 is full, so let's put SPARK alloy in slot 2. Slot 2 is full, so let's put SPARK alloy in slot 3. You put the SPARK alloy into slot 3.

>press go
Ingredient list: MEND alloy, SHIELD alloy and SPARK alloy

* * *

 

 

Supply Room
You are standing in a spacious room made of reinforced concrete. A lighting panel illuminates the room in a tense white glow. There is another room to the SOUTH.

An alcove is carved into the wall in front of you. Hovering in the alcove are a SHIELD alloy, a BLADE alloy, an ENTROPIC alloy, a MEND alloy and a SPARK alloy.

A large red button labeled RESUPPLY is mounted above the alcove.

>take mend, spark and blade
MEND alloy: Test this
Taken.
SPARK alloy: Test 
Taken.
BLADE alloy: Test 
Taken.

>combine
Combination Station
WELCOME TO THE QUALIFICATION DETERMINATION SIMULATION COMBINATION STATION! HERE YOU CAN TAKE ELEMENTS FROM THE PREVIOUS ROOM AND FORM THEM INTO NEW AND FANCIFUL CREATIONS. WHAT ARE YOU WAITING FOR? LET'S GET CREATIVE!

You are standing in another concrete room. There are exits to the North and South. In the center is a vast machine labeled 'Combinator'. The machine has 3 slots to put elements in:

Slot 1 is empty.

Slot 2 is empty.

Slot 3 is empty.

You can also see a green button labelled GO here.

You put the BLADE alloy into slot 1.

Slot 1 is full, so let's put MEND alloy in slot 2. You put the MEND alloy into slot 2.

Slot 1 is full, so let's put SPARK alloy in slot 2. Slot 2 is full, so let's put SPARK alloy in slot 3. You put the SPARK alloy into slot 3.

>press go
Ingredient list: BLADE alloy, MEND alloy and SPARK alloyThe BLADE alloy warps itself into a long syringe, and the MEND alloy fills it with a healing light! The SPARK alloy thinks it can improve on this design, and restructures the healing item to a small, intense green ball of light.

>look
rate 5 stars
THANK YOU FOR YOUR FEEDBACK!

>look
Combination Station

You are standing in another concrete room. There are exits to the North and South. In the center is a vast machine labeled 'Combinator'. The machine has 3 slots to put elements in:

Slot 1 is empty.

Slot 2 is empty.

Slot 3 is empty.

You can also see a green button labelled GO here.

>n
Supply Room
You are standing in a spacious room made of reinforced concrete. A lighting panel illuminates the room in a tense white glow. There is another room to the south.

An alcove is carved into the wall in front of you. Hovering in the alcove are a SPARK alloy, a MEND alloy, a BLADE alloy, a SHIELD alloy and an ENTROPIC alloy.

A large red button labeled RESUPPLY is mounted above the alcove.

* * *

 

 

Supply Room
You are standing in a spacious room made of reinforced concrete. A lighting panel illuminates the room in a tense white glow. There is another room to the SOUTH.

An alcove is carved into the wall in front of you. Hovering in the alcove are a SHIELD alloy, a BLADE alloy, an ENTROPIC alloy, a MEND alloy and a SPARK alloy.

A large red button labeled RESUPPLY is mounted above the alcove.

>take mend, spark and entropic
MEND alloy: Test this
Taken.
SPARK alloy: Test 
Taken.
ENTROPIC alloy: Test 
Taken.

>combine
Combination Station
WELCOME TO THE QUALIFICATION DETERMINATION SIMULATION COMBINATION STATION! HERE YOU CAN TAKE ELEMENTS FROM THE PREVIOUS ROOM AND FORM THEM INTO NEW AND FANCIFUL CREATIONS. WHAT ARE YOU WAITING FOR? LET'S GET CREATIVE!

You are standing in another concrete room. There are exits to the North and South. In the center is a vast machine labeled 'Combinator'. The machine has 3 slots to put elements in:

Slot 1 is empty.

Slot 2 is empty.

Slot 3 is empty.

You can also see a green button labelled GO here.

You put the ENTROPIC alloy into slot 1.

Slot 1 is full, so let's put MEND alloy in slot 2. You put the MEND alloy into slot 2.

Slot 1 is full, so let's put SPARK alloy in slot 2. Slot 2 is full, so let's put SPARK alloy in slot 3. You put the SPARK alloy into slot 3.

>press go
Ingredient list: ENTROPIC alloy, MEND alloy and SPARK alloyThe ENTROPIC and MELD alloys react violently with one another, and the SPARK alloy struggles to contain them! Eventually it coalesces into a rod that sparks and surges with unstable energy.

>inv
rate 5 stars
THANK YOU FOR YOUR FEEDBACK!

>z
Time passes.

>x lightning rod
You see nothing special about the lightning rod.

I ADMIRE YOUR INQUISITIVE NATURE!
THE RATING MODULE IS BACK WITH ANOTHER MESSAGE! ISN'T HE CUTE?

 Please rate the description of the lightning rod:

5 - Life changing

4 - Impressive

3 - Mediocre

2 - Trivial

1 - Disgusting

[Your score has just gone up by five points.]

* * *

>press go
Ingredient list: ENTROPIC alloy, MEND alloy and SPARK alloyThe ENTROPIC and MELD alloys react violently with one another, and the SPARK alloy struggles to contain them! Eventually it coalesces into a rod that sparks and surges with unstable energy.

>n
rate 1 stars
THANK YOU FOR YOUR FEEDBACK!

>look
Supply Room
You are standing in a spacious room made of reinforced concrete. A lighting panel illuminates the room in a tense white glow. There is another room to the south.

An alcove is carved into the wall in front of you. Hovering in the alcove are a SPARK alloy, a MEND alloy, an ENTROPIC alloy, a SHIELD alloy and a BLADE alloy.

A large red button labeled RESUPPLY is mounted above the alcove.

* * *

 

 

Supply Room
You are standing in a spacious room made of reinforced concrete. A lighting panel illuminates the room in a tense white glow. There is another room to the SOUTH.

An alcove is carved into the wall in front of you. Hovering in the alcove are a SHIELD alloy, a BLADE alloy, an ENTROPIC alloy, a MEND alloy and a SPARK alloy.

A large red button labeled RESUPPLY is mounted above the alcove.

>take mend, spark and shied
You can't see any such thing.

>take mend, spark and shield
MEND alloy: Test this
Taken.
SPARK alloy: Test 
Taken.
SHIELD alloy: Test 
Taken.

>combine
Combination Station
WELCOME TO THE QUALIFICATION DETERMINATION SIMULATION COMBINATION STATION! HERE YOU CAN TAKE ELEMENTS FROM THE PREVIOUS ROOM AND FORM THEM INTO NEW AND FANCIFUL CREATIONS. WHAT ARE YOU WAITING FOR? LET'S GET CREATIVE!

You are standing in another concrete room. There are exits to the North and South. In the center is a vast machine labeled 'Combinator'. The machine has 3 slots to put elements in:

Slot 1 contains nothing.

Slot 2 contains nothing.

Slot 3 contains nothing.

You can also see a green button labelled GO here.

You put the SHIELD alloy into slot 1.

Slot 1 is full, so let's put MEND alloy in slot 2. You put the MEND alloy into slot 2.

Slot 1 is full, so let's put SPARK alloy in slot 2. Slot 2 is full, so let's put SPARK alloy in slot 3. You put the SPARK alloy into slot 3.

>press go
INgredients: SHIELD alloy, MEND alloy and SPARK alloy

>take mend
Test 
Taken.

HELLO AGAIN! I'D LIKE TO INTRODUCE... THE RATINGS MODULE! HUMAN FEEDBACK IS CRUCIAL TO CREATIVITRIX, AND THIS LITTLE GUY IS HERE TO COLLECT IT! I'LL LET HIM TALK:

 Please rate your experience with the CREATIVITRIX QUALIFICATION DETERMINATION SIMULATION thus far:

5 - Excellent

4 - Appealing

3 - Unremarkable

2 - Lackluster

1 - Truly Awful

>rate 1
I didn't understand that sentence.

>rate 1 stars
THANK YOU FOR YOUR FEEDBACK!

>take mend
You already have that.

>take spark
Test 
Taken.

>put mend
(in slot 1)
Slot 1 is full, so let's put MEND alloy in slot 2. You put the MEND alloy into slot 2.

>look
Combination Station

You are standing in another concrete room. There are exits to the North and South. In the center is a vast machine labeled 'Combinator'. The machine has 3 slots to put elements in:

Slot 1 is empty.

Slot 2 is empty.

Slot 3 contains nothing.

You can also see a green button labelled GO here.

>look slot 3
rate 5 stars

>look slot 3
Slot 3 is empty.

>look
Combination Station

You are standing in another concrete room. There are exits to the North and South. In the center is a vast machine labeled 'Combinator'. The machine has 3 slots to put elements in:

Slot 1 is empty.

Slot 2 is empty.

Slot 3 contains nothing.

You can also see a green button labelled GO here.

>inv
You are carrying:
  a SPARK alloy

>take shield
Test 
Taken.

>look
Combination Station

You are standing in another concrete room. There are exits to the North and South. In the center is a vast machine labeled 'Combinator'. The machine has 3 slots to put elements in:

Slot 1 contains nothing.

Slot 2 is empty.

Slot 3 contains nothing.

You can also see a green button labelled GO here.

>look in slot 2
In slot 2 is a MEND alloy.

>take mend
Test 
Taken.

>look
Combination Station

You are standing in another concrete room. There are exits to the North and South. In the center is a vast machine labeled 'Combinator'. The machine has 3 slots to put elements in:

Slot 1 contains nothing.

Slot 2 contains nothing.

Slot 3 contains nothing.

You can also see a green button labelled GO here.

* * *

 

 

Supply Room
You are standing in a spacious room made of reinforced concrete. A lighting panel illuminates the room in a tense white glow. There is another room to the SOUTH.

An alcove is carved into the wall in front of you. Hovering in the alcove are a SHIELD alloy, a BLADE alloy, an ENTROPIC alloy, a MEND alloy and a SPARK alloy.

A large red button labeled RESUPPLY is mounted above the alcove.

>take mend, spark and shield
MEND alloy: Taken.
SPARK alloy: Taken.
SHIELD alloy: Taken.

>combine
Combination Station
WELCOME TO THE QUALIFICATION DETERMINATION SIMULATION COMBINATION STATION! HERE YOU CAN TAKE ALLOYS FROM THE PREVIOUS ROOM AND FORM THEM INTO NEW AND FANCIFUL CREATIONS. WHAT ARE YOU WAITING FOR? LET'S GET CREATIVE!

You are standing in another concrete room. There are exits to the North and South. In the center is a vast machine labeled 'Combinator'. The machine has 3 slots to put alloys in:

Slot 1 is empty.

Slot 2 is empty.

Slot 3 is empty.

You can also see a green button labelled GO and Intern Jim here.

You walk to the Combination Station.

You put the SHIELD alloy into slot 1.

Slot 1 is full, so let's put MEND alloy in slot 2. You put the MEND alloy into slot 2.

Slot 1 is full, so let's put SPARK alloy in slot 2. Slot 2 is full, so let's put SPARK alloy in slot 3. You put the SPARK alloy into slot 3.

>combine
There's 0 free slots and you are only carrying 0 alloys. Go take another and try again!

* * *

>press button
You can't see any such thing.

>n
Supply Room
You are standing in a spacious room made of reinforced concrete. A lighting panel illuminates the room in a tense white glow. There is another room to the south.

An alcove is carved into the wall in front of you. Hovering in the alcove are a BLADE alloy and an ENTROPIC alloy.

A large red button labeled RESUPPLY is mounted above the alcove.

>press button
It is fixed in place.

* * *

>press go
Ingredient list: MEND alloy, SHIELD alloy and SPARK alloy

The SHIELD and MELD elements combine to form a magical helmet, and the SPARK alloy makes itself busy by creating a system that diagnoses and heals your wounds. Neat!
NICE COMBO DROMBO

* * *

 

 

Supply Room
You are standing in a spacious room made of reinforced concrete. A lighting panel illuminates the room in a tense white glow. There is another room to the SOUTH.

An alcove is carved into the wall in front of you. Hovering in the alcove are a SHIELD alloy, a BLADE alloy, an ENTROPIC alloy, a MEND alloy and a SPARK alloy.

A large red button labeled RESUPPLY is mounted above the alcove.

>take red
YOU CAN'T TAKE THAT LARGE RED BUTTON LABELED RESUPPLY. NICE IDEA, THOUGH!

[Your score has just gone up by five points.]

* * *

 

 

Supply Room
You are standing in a spacious room made of reinforced concrete. A lighting panel illuminates the room in a tense white glow. There is another room to the SOUTH.

An alcove is carved into the wall in front of you. Hovering in the alcove are a SHIELD alloy, a BLADE alloy, an ENTROPIC alloy, a MEND alloy and a SPARK alloy.

A large red button labeled RESUPPLY is mounted above the alcove.

>take salve, spark and shield
SALVE alloy: Test this
Taken.
SPARK alloy: Test 
Taken.
SHIELD alloy: Test 
Taken.

>combine
What do you want to combine?

>combine spark
Head SOUTH to the Combination Station to combine elements.

>combine spark, shield and salve
You can't use multiple objects with that verb.

* * *

 

 

Supply Room
You are standing in a spacious room made of reinforced concrete. A lighting panel illuminates the room in a tense white glow. There is another room to the SOUTH.

An alcove is carved into the wall in front of you. Hovering in the alcove are a SHIELD alloy, a BLADE alloy, an ENTROPIC alloy, a MEND alloy and a SPARK alloy.

A large red button labeled RESUPPLY is mounted above the alcove.

>take shield
Taken.

* * *

>kiss shield
You can only do that to something animate.

>mend shield
That's not a verb I recognise.

>look shield
A fist-sized cube of pure SHIELD alloy is hovering in front of you. It seems eager to morph into something useful.

I ADMIRE YOUR INQUISITIVE NATURE!

[Your score has just gone up by five points.]

* * *

>look blade
A sheet of pure BLADE alloy hovers in front of you, light glinting dangerously off its surface. It seems eager to morph into something sharp.

I ADMIRE YOUR EXPLORATORY NATURE!

[Your score has just gone up by five points.]

>take shield
You already have that.

>take blade
Taken.

* * *

>take entropic
Taken.

>combine
Combination Station
WELCOME TO THE QUALIFICATION DETERMINATION SIMULATION COMBINATION STATION! HERE YOU CAN TAKE ALLOYS FROM THE PREVIOUS ROOM AND FORM THEM INTO NEW AND FANCIFUL CREATIONS. WHAT ARE YOU WAITING FOR? LET'S GET CREATIVE!

You are standing in another concrete room. There are exits to the North and South. In the center is a vast machine labeled 'Combinator'. The machine has 3 slots to put alloys in:

Slot 1 is empty.

Slot 2 is empty.

Slot 3 is empty.

You can also see a green button labelled GO and Intern Jim here.

You walk to the Combination Station.

You put the SHIELD alloy into slot 1.

Slot 1 is full, so let's put BLADE alloy in slot 2. You put the BLADE alloy into slot 2.

Slot 1 is full, so let's put ENTROPIC alloy in slot 2. Slot 2 is full, so let's put ENTROPIC alloy in slot 3. You put the ENTROPIC alloy into slot 3.

>go
You'll have to say which compass direction to go in.

>north
Supply Room
You are standing in a spacious room made of reinforced concrete. A lighting panel illuminates the room in a tense white glow. There is another room to the south.

An alcove is carved into the wall in front of you. Hovering in the alcove are a MEND alloy and a SPARK alloy.

A large red button labeled RESUPPLY is mounted above the alcove.

>south
Combination Station

You are standing in another concrete room. There are exits to the North and South. In the center is a vast machine labeled 'Combinator'. The machine has 3 slots to put alloys in:

Slot 1 contains a SHIELD alloy.

Slot 2 contains a BLADE alloy.

Slot 3 contains an ENTROPIC alloy.

You can also see a green button labelled GO and Intern Jim here.

>go
You'll have to say which compass direction to go in.

>press button
Ingredient list: BLADE alloy, ENTROPIC alloy and SHIELD alloy

The SHIELD alloy quickly wraps itself around the volatile ENTROPIC alloy. Then, the BLADE alloy adds dangerous-looking spikes to the outside of the resulting ball.

AMAZING! THAT'S AN INCREDIBLE SPIKED GRENADE YOU'VE JUST CREATED! I'M AWARDING YOU 20 CREATIVITY POINTS FOR IT.

You now carry a brand-new spiked grenade.

[Your score has just gone up by twenty points.]

* * *

 

 

Supply Room
You are standing in a spacious room made of reinforced concrete. A lighting panel illuminates the room in a tense white glow. There is another room to the SOUTH.

An alcove is carved into the wall in front of you. Hovering in the alcove are a SHIELD alloy, a BLADE alloy, an ENTROPIC alloy, a MEND alloy and a SPARK alloy.

A large red button labeled RESUPPLY is mounted above the alcove.

>take shield and entropi
You can't see any such thing.

>take shield and entropic
SHIELD alloy: Test this
Taken.
ENTROPIC alloy: Test 
Taken.

>s
Combination Station
WELCOME TO THE QUALIFICATION DETERMINATION SIMULATION COMBINATION STATION! HERE YOU CAN TAKE ELEMENTS FROM THE PREVIOUS ROOM AND FORM THEM INTO NEW AND FANCIFUL CREATIONS. WHAT ARE YOU WAITING FOR? LET'S GET CREATIVE!

You are standing in another concrete room. There are exits to the North and South. In the center is a vast machine labeled 'Combinator'. The machine has 3 slots to put elements in:

Slot 1 contains nothing.

>put shield in 1
You put the SHIELD alloy into slot 1.

* * *

 

 

Supply Room
You are standing in a spacious room made of reinforced concrete. A lighting panel illuminates the room in a tense white glow. There is another room to the SOUTH.

An alcove is carved into the wall in front of you. Hovering in the alcove are a SHIELD alloy, a BLADE alloy, an ENTROPIC alloy, a MEND alloy and a SPARK alloy.

A large red button labeled RESUPPLY is mounted above the alcove.

>take shield, blade and entropic
SHIELD alloy: Test this
Taken.
BLADE alloy: Test 
Taken.
ENTROPIC alloy: Test 
Taken.

>combine
Combination Station
WELCOME TO THE QUALIFICATION DETERMINATION SIMULATION COMBINATION STATION! HERE YOU CAN TAKE ELEMENTS FROM THE PREVIOUS ROOM AND FORM THEM INTO NEW AND FANCIFUL CREATIONS. WHAT ARE YOU WAITING FOR? LET'S GET CREATIVE!

You are standing in another concrete room. There are exits to the North and South. In the center is a vast machine labeled 'Combinator'. The machine has 3 slots to put elements in:

Slot 1 is empty.

Slot 2 is empty.

Slot 3 is empty.

You can also see a green button labelled GO here.

You put the SHIELD alloy into slot 1.

Slot 1 is full, so let's put BLADE alloy in slot 2. You put the BLADE alloy into slot 2.

Slot 1 is full, so let's put ENTROPIC alloy in slot 2. Slot 2 is full, so let's put ENTROPIC alloy in slot 3. You put the ENTROPIC alloy into slot 3.

>press go
Ingredient list: BLADE alloy, ENTROPIC alloy and SHIELD alloy

The SHIELD alloy quickly wraps itself around the volatile ENTROPIC alloy. Then, the BLADE alloy adds dangerous-looking spikes to the outside of the resulting ball.

>inv
rate 5 stars
THANK YOU FOR YOUR FEEDBACK!

>n
Supply Room
You are standing in a spacious room made of reinforced concrete. A lighting panel illuminates the room in a tense white glow. There is another room to the south.

An alcove is carved into the wall in front of you. Hovering in the alcove are a MEND alloy and a SPARK alloy.

A large red button labeled RESUPPLY is mounted above the alcove.

>look
Supply Room
You are standing in a spacious room made of reinforced concrete. A lighting panel illuminates the room in a tense white glow. There is another room to the south.

An alcove is carved into the wall in front of you. Hovering in the alcove are a MEND alloy and a SPARK alloy.

A large red button labeled RESUPPLY is mounted above the alcove.

>press go
You can't see any such thing.

>press button
Here are all the alloys: SHIELD alloy, BLADE alloy, ENTROPIC alloy, MEND alloy and SPARK alloyA BLADE alloy zaps into existence!
A SHIELD alloy teleports in!

* * *

 

 

Supply Room
You are standing in a spacious room made of reinforced concrete. A lighting panel illuminates the room in a tense white glow. There is another room to the SOUTH.

An alcove is carved into the wall in front of you. Hovering in the alcove are a SHIELD alloy, a BLADE alloy, an ENTROPIC alloy, a MEND alloy and a SPARK alloy.

A large red button labeled RESUPPLY is mounted above the alcove.

>take shield, meld and spark
You can't see any such thing.

>take shield, mend and spark
SHIELD alloy: Test this
Taken.
MEND alloy: Test 
Taken.
SPARK alloy: Test 
Taken.

>combine
Combination Station
WELCOME TO THE QUALIFICATION DETERMINATION SIMULATION COMBINATION STATION! HERE YOU CAN TAKE ELEMENTS FROM THE PREVIOUS ROOM AND FORM THEM INTO NEW AND FANCIFUL CREATIONS. WHAT ARE YOU WAITING FOR? LET'S GET CREATIVE!

You are standing in another concrete room. There are exits to the North and South. In the center is a vast machine labeled 'Combinator'. The machine has 3 slots to put elements in:

Slot 1 is empty.

Slot 2 is empty.

Slot 3 is empty.

You can also see a green button labelled GO here.

You put the SHIELD alloy into slot 1.

Slot 1 is full, so let's put MEND alloy in slot 2. You put the MEND alloy into slot 2.

Slot 1 is full, so let's put SPARK alloy in slot 2. Slot 2 is full, so let's put SPARK alloy in slot 3. You put the SPARK alloy into slot 3.

>press go
Ingredient list: MEND alloy, SHIELD alloy and SPARK alloyThe SHIELD and MELD elements combine to form a magical helmet, and the SPARK alloy makes itself busy by creating a system that diagnoses and heals your wounds. Neat!

>look
rate 1 stars
THANK YOU FOR YOUR FEEDBACK!

>look
Combination Station

You are standing in another concrete room. There are exits to the North and South. In the center is a vast machine labeled 'Combinator'. The machine has 3 slots to put elements in:

Slot 1 is empty.

Slot 2 is empty.

Slot 3 is empty.

You can also see a green button labelled GO here.

* * *

 

 

Supply Room
You are standing in a spacious room made of reinforced concrete. A lighting panel illuminates the room in a tense white glow. There is another room to the SOUTH.

An alcove is carved into the wall in front of you. Hovering in the alcove are a SHIELD alloy, a BLADE alloy, an ENTROPIC alloy, a MEND alloy and a SPARK alloy.

A large red button labeled RESUPPLY is mounted above the alcove.

>take shield, mend and spark
SHIELD alloy: Taken.
MEND alloy: Taken.
SPARK alloy: Taken.

>eat spark
You put the SPARK alloy in your mouth. It tastes like chewing on aluminum foil coated in pop rocks. You spit it out.

EXCELLENT! BE SURE TO INSPECT YOUR ENVIRONMENT CAREFULLY!

[Your score has just gone up by five points.]

* * *

 

 

Supply Room
You are standing in a spacious room made of reinforced concrete. A lighting panel illuminates the room in a tense white glow. There is another room to the SOUTH.

An alcove is carved into the wall in front of you. Hovering in the alcove are a SHIELD alloy, a BLADE alloy, an ENTROPIC alloy, a MEND alloy and a SPARK alloy.

A large red button labeled RESUPPLY is mounted above the alcove.

>take spark, mend and shield
SPARK alloy: Test this
Taken.
MEND alloy: Test 
Taken.
SHIELD alloy: Test 
Taken.

>combine
Combination Station
WELCOME TO THE QUALIFICATION DETERMINATION SIMULATION COMBINATION STATION! HERE YOU CAN TAKE ELEMENTS FROM THE PREVIOUS ROOM AND FORM THEM INTO NEW AND FANCIFUL CREATIONS. WHAT ARE YOU WAITING FOR? LET'S GET CREATIVE!

You are standing in another concrete room. There are exits to the North and South. In the center is a vast machine labeled 'Combinator'. The machine has 3 slots to put elements in:

Slot 1 is empty.

Slot 2 is empty.

Slot 3 is empty.

You can also see a green button labelled GO here.

You put the SHIELD alloy into slot 1.

Slot 1 is full, so let's put MEND alloy in slot 2. You put the MEND alloy into slot 2.

Slot 1 is full, so let's put SPARK alloy in slot 2. Slot 2 is full, so let's put SPARK alloy in slot 3. You put the SPARK alloy into slot 3.

>press go
Ingredient list: MEND alloy, SHIELD alloy and SPARK alloy

The SHIELD and MELD elements combine to form a magical helmet, and the SPARK alloy makes itself busy by creating a system that diagnoses and heals your wounds. Neat!
AMAZING! THAT'S AN INCREDIBLE HEALING HELMET YOU'VE JUST CREATED! I'M AWARDING YOU 20 CREATIVITY POINTS FOR IT.

[Your score has just gone up by twenty points.]

>n
rate 5 stars
THANK YOU FOR YOUR FEEDBACK!

>look
Supply Room
You are standing in a spacious room made of reinforced concrete. A lighting panel illuminates the room in a tense white glow. There is another room to the south.

An alcove is carved into the wall in front of you. Hovering in the alcove are a BLADE alloy and an ENTROPIC alloy.

A large red button labeled RESUPPLY is mounted above the alcove.

>press resupply
A SHIELD alloy teleports in!
A BLADE alloy zaps in!
An ENTROPIC alloy warps in!
A MEND alloy pops into existence!
A SPARK alloy respawns!

* * *

 

 

Supply Room
You are standing in a spacious room made of reinforced concrete. A lighting panel illuminates the room in a tense white glow. There is another room to the SOUTH.

An alcove is carved into the wall in front of you. Hovering in the alcove are a SHIELD alloy, a BLADE alloy, an ENTROPIC alloy, a MEND alloy and a SPARK alloy.

A large red button labeled RESUPPLY is mounted above the alcove.

>take spark, shield and entropic
SPARK alloy: Test this
Taken.
SHIELD alloy: Test 
Taken.
ENTROPIC alloy: Test 
Taken.

>combine
Combination Station
WELCOME TO THE QUALIFICATION DETERMINATION SIMULATION COMBINATION STATION! HERE YOU CAN TAKE ELEMENTS FROM THE PREVIOUS ROOM AND FORM THEM INTO NEW AND FANCIFUL CREATIONS. WHAT ARE YOU WAITING FOR? LET'S GET CREATIVE!

You are standing in another concrete room. There are exits to the North and South. In the center is a vast machine labeled 'Combinator'. The machine has 3 slots to put elements in:

Slot 1 is empty.

Slot 2 is empty.

Slot 3 is empty.

You can also see a green button labelled GO here.

You put the SHIELD alloy into slot 1.

Slot 1 is full, so let's put ENTROPIC alloy in slot 2. You put the ENTROPIC alloy into slot 2.

Slot 1 is full, so let's put SPARK alloy in slot 2. Slot 2 is full, so let's put SPARK alloy in slot 3. You put the SPARK alloy into slot 3.

>press go
Ingredient list: ENTROPIC alloy, SHIELD alloy and SPARK alloy

The SHIELD alloy quickly warps itself around the volatile ENTROPIC alloy. Then, the SPARK alloy adds some cool extra features!
NICE COMBO DROMBO

>drop grenade
rate 5 stars
THANK YOU FOR YOUR FEEDBACK!

>take grenade
Taken.

* * *

 

 

Supply Room
You are standing in a spacious room made of reinforced concrete. A lighting panel illuminates the room in a tense white glow. There is another room to the SOUTH.

An alcove is carved into the wall in front of you. Hovering in the alcove are a SHIELD alloy, a BLADE alloy, an ENTROPIC alloy, a MEND alloy and a SPARK alloy.

A large red button labeled RESUPPLY is mounted above the alcove.

>take spark, shield and mend
SPARK alloy: Test this
Taken.
SHIELD alloy: Test 
Taken.
MEND alloy: Test 
Taken.

>s
Combination Station
WELCOME TO THE QUALIFICATION DETERMINATION SIMULATION COMBINATION STATION! HERE YOU CAN TAKE ELEMENTS FROM THE PREVIOUS ROOM AND FORM THEM INTO NEW AND FANCIFUL CREATIONS. WHAT ARE YOU WAITING FOR? LET'S GET CREATIVE!

You are standing in another concrete room. There are exits to the North and South. In the center is a vast machine labeled 'Combinator'. The machine has 3 slots to put elements in:

Slot 1 is empty.

Slot 2 is empty.

Slot 3 is empty.

You can also see a green button labelled GO here.

* * *

>n
rate 5 stars
THANK YOU FOR YOUR FEEDBACK!

>combine
Combination Station

You are standing in another concrete room. There are exits to the North and South. In the center is a vast machine labeled 'Combinator'. The machine has 3 slots to put elements in:

Slot 1 is empty.

Slot 2 is empty.

Slot 3 is empty.

You can also see a green button labelled GO here.

You put the SHIELD alloy into slot 1.

Slot 1 is full, so let's put MEND alloy in slot 2. You put the MEND alloy into slot 2.

Slot 1 is full, so let's put SPARK alloy in slot 2. Slot 2 is full, so let's put SPARK alloy in slot 3. You put the SPARK alloy into slot 3.

>press go
Ingredient list: MEND alloy, SHIELD alloy and SPARK alloy

The SHIELD and MELD elements combine to form a magical helmet, and the SPARK alloy makes itself busy by creating a system that diagnoses and heals your wounds. Neat!

>inv
You are carrying:
  a healing helmet

>drop helmet
Dropped.

>take helmet
WOAH NELLY

* * *

 

 

Supply Room
You are standing in a spacious room made of reinforced concrete. A lighting panel illuminates the room in a tense white glow. There is another room to the SOUTH.

An alcove is carved into the wall in front of you. Hovering in the alcove are a SHIELD alloy, a BLADE alloy, an ENTROPIC alloy, a MEND alloy and a SPARK alloy.

A large red button labeled RESUPPLY is mounted above the alcove.

>talk tl me
That's not a verb I recognise.

>ask me about me
You talk to yourself for a little bit. You're a great conversation partner!

I beg your pardon?

>s
Combination Station
WELCOME TO THE QUALIFICATION DETERMINATION SIMULATION COMBINATION STATION! HERE YOU CAN TAKE ELEMENTS FROM THE PREVIOUS ROOM AND FORM THEM INTO NEW AND FANCIFUL CREATIONS. WHAT ARE YOU WAITING FOR? LET'S GET CREATIVE!

You are standing in another concrete room. There are exits to the North and South. In the center is a vast machine labeled 'Combinator'. The machine has 3 slots to put elements in:

Slot 1 is empty.

Slot 2 is empty.

Slot 3 is empty.

You can also see a green button labelled GO and Intern Jim here.

>ask jim about entropy
Jim looks uncomfortable. "Entropy... They say that even storing information about it is a vector for it to infect you. All we know is that Entropy has destroyed a lot of civilization. We don't know where it is, what it is, what it wants, or anything... It's even dangerous just to have this Entropy in the simulation."

>ask jim about entity
Jim nods politely, but clearly doesn't have any idea what you're talking about.

* * *

 

 

Supply Room
You are standing in a spacious room made of reinforced concrete. A lighting panel illuminates the room in a tense white glow. There is another room to the SOUTH.

An alcove is carved into the wall in front of you. Hovering in the alcove are a SHIELD alloy, a BLADE alloy, an ENTROPIC alloy, a MEND alloy and a SPARK alloy.

A large red button labeled RESUPPLY is mounted above the alcove.

>taste alcove
You lick the concrete. You think somone once told you this is how you get "stoned."

EXCELLENT! BE SURE TO INSPECT YOUR ENVIRONMENT CAREFULLY!

[Your score has just gone up by five points.]

>smell alcove
You sniff the concrete. You think somone once told you this is how you get "stoned."

You smell nothing unexpected.

* * *

 

 

Supply Room
You are standing in a spacious room made of reinforced concrete. A lighting panel illuminates the room in a tense white glow. There is another room to the SOUTH.

An alcove is carved into the wall in front of you. Hovering in the alcove are a SHIELD alloy, a BLADE alloy, an ENTROPIC alloy, a MEND alloy and a SPARK alloy.

A large red button labeled RESUPPLY is mounted above the alcove.

>taste lights
You can't reach the panel from down here. Instead, you close your eyes and imagine a warm sunrise basking over your tongue.

EXCELLENT! BE SURE TO INSPECT YOUR ENVIRONMENT CAREFULLY!

[Your score has just gone up by five points.]

>x lights
A flat white panel is embedded in the concrete on the ceiling. It glows with a uniform brightness.

I ADMIRE YOUR INQUISITIVE NATURE!

[Your score has just gone up by five points.]

>taste lights
You can't reach the panel from down here. Instead, you close your eyes and imagine a warm sunrise basking over your tongue.

>jump
You jump on the spot.

HELLO AGAIN! I'D LIKE TO INTRODUCE... THE RATINGS MODULE! HUMAN FEEDBACK IS CRUCIAL TO CREATIVITRIX, AND THIS LITTLE GUY IS HERE TO COLLECT IT! I'LL LET HIM TALK:

 Please rate your experience with the CREATIVITRIX QUALIFICATION DETERMINATION SIMULATION thus far:

5 - Excellent

4 - Appealing

3 - Unremarkable

2 - Lackluster

1 - Truly Awful

>x entropic
rate 3 stars
THANK YOU FOR YOUR FEEDBACK!

>x entropic
A writhing ball of pure ENTROPY hovers in front of you. It hurts to look at.

I ADMIRE YOUR EXPLORATORY NATURE!

[Your score has just gone up by five points.]

>x entropic
A writhing ball of pure ENTROPY hovers in front of you. It hurts to look at.

>x entropic
A writhing ball of pure ENTROPY hovers in front of you. It hurts to look at.

>x lights
A flat white panel is embedded in the concrete on the ceiling. It glows with a uniform brightness.

* * *

 

 

Supply Room
You are standing in a spacious room made of reinforced concrete. A lighting panel illuminates the room in a tense white glow. There is another room to the SOUTH.

An alcove is carved into the wall in front of you. Hovering in the alcove are a SHIELD alloy, a BLADE alloy, an ENTROPIC alloy, a MEND alloy and a SPARK alloy.

A large red button labeled RESUPPLY is mounted above the alcove.

>taste salve
You taste nothing unexpected.

>s
Combination Station

>look
Combination Station

>n
Supply Room
You are standing in a spacious room made of reinforced concrete. A lighting panel illuminates the room in a tense white glow.

An alcove is carved into the wall in front of you. Hovering in the alcove are a SHIELD alloy, a BLADE alloy, an ENTROPIC alloy, a SALVE alloy and a SPARK alloy.

A large red button labeled RESUPPLY is mounted above the alcove.

>look
Supply Room
You are standing in a spacious room made of reinforced concrete. A lighting panel illuminates the room in a tense white glow.

An alcove is carved into the wall in front of you. Hovering in the alcove are a SHIELD alloy, a BLADE alloy, an ENTROPIC alloy, a SALVE alloy and a SPARK alloy.

A large red button labeled RESUPPLY is mounted above the alcove.

* * *

 

 

Supply Room
You are standing in a spacious room made of reinforced concrete. A lighting panel illuminates the room in a tense white glow. There is another room to the SOUTH.

An alcove is carved into the wall in front of you. Hovering in the alcove are a SHIELD alloy, a BLADE alloy, an ENTROPIC alloy, a MEND alloy and a SPARK alloy.

A large red button labeled RESUPPLY is mounted above the alcove.

>taste shield
You gingerly lick the SHIELD alloy. It tastes like iron, strength and security.

EXCELLENT! BE SURE TO INSPECT YOUR ENVIRONMENT CAREFULLY!

[Your score has just gone up by five points.]

* * *

 

 

Supply Room
You are standing in a spacious room made of reinforced concrete. A lighting panel illuminates the room in a tense white glow. There is another room to the SOUTH.

An alcove is carved into the wall in front of you. Hovering in the alcove are a SHIELD alloy, a BLADE alloy, an ENTROPIC alloy, a MEND alloy and a SPARK alloy.

A large red button labeled RESUPPLY is mounted above the alcove.

>throw mend alloy at light
(first taking the MEND alloy)
You throw the MEND alloy at the lighting panel. Bonk! The MEND alloy lands on the floor.

* * *

 

 

Supply Room
You are standing in a spacious room made of reinforced concrete. A lighting panel illuminates the room in a tense white glow. There is another room to the SOUTH.

An alcove is carved into the wall in front of you. Hovering in the alcove are a SHIELD alloy, a BLADE alloy, an ENTROPIC alloy, a MEND alloy and a SPARK alloy.

A large red button labeled RESUPPLY is mounted above the alcove.

>throw mend at light
(first taking the MEND alloy)
The lighting panel is unfazed by your attempts to bring it off its high horse.

HUMAN, WHAT DID THAT LIGHT EVER DO TO YOU?

You throw the MEND alloy at the lighting panel. Bonk! The MEND alloy lands on the floor.

GOOD THROWING ARM! I DON'T HAVE ARMS, SO THAT'S ESPECIALLY IMPRESSIVE.

[Your score has just gone up by five points.]

>attack light
You've always fantasized about fighting a light. But it doesn't feel right, because fighting the light might leave you in night.

>hit light
You've always fantasized about fighting a light. But it doesn't feel right, because fighting the light might leave you in night.

>look
rate 5 stars
THANK YOU FOR YOUR FEEDBACK!

* * *

>throw mend at light
(first taking the MEND alloy)
The lighting panel is unfazed by your attempts to bring it off its high horse.

HUMAN, WHAT DID THAT LIGHT EVER DO TO YOU?

You throw the MEND alloy at the lighting panel. Bonk! The MEND alloy lands on the floor.

GOOD THROWING ARM! I DON'T HAVE ARMS, SO THAT'S ESPECIALLY IMPRESSIVE.

[Your score has just gone up by five points.]

>eat mend
EXCELLENT! BE SURE TO INSPECT YOUR ENVIRONMENT CAREFULLY!

[Your score has just gone up by five points.]

* * *

>throw mend at light
(first taking the MEND alloy)
The lighting panel is unfazed by your attempts to bring it off its high horse.

HUMAN, WHAT DID THAT LIGHT EVER DO TO YOU?

You throw the MEND alloy at the lighting panel. Bonk! The MEND alloy lands on the floor.

GOOD THROWING ARM! I DON'T HAVE ARMS, SO THAT'S ESPECIALLY IMPRESSIVE.

[Your score has just gone up by five points.]

>rules all
Rules tracing now switched to "all". Type "rules off" to switch it off again.

* * *

>throw mend at light
(first taking the MEND alloy)
The lighting panel is unfazed by your attempts to bring it off its high horse.

HUMAN, WHAT DID THAT LIGHT EVER DO TO YOU?

You throw the MEND alloy at the lighting panel. Bonk! The MEND alloy lands on the floor.

GOOD THROWING ARM! I DON'T HAVE ARMS, SO THAT'S ESPECIALLY IMPRESSIVE.

[Your score has just gone up by five points.]

>throw light at mend
(first taking the lighting panel)
YOU CAN'T TAKE THAT LIGHTING PANEL. NICE IDEA, THOUGH!

[Your score has just gone up by five points.]

>throw mend at button
(first taking the MEND alloy)
You throw the MEND alloy at the large red button labeled RESUPPLY. Bonk! The MEND alloy lands on the floor.

Nice shot! The MEND alloy pushes the button for you! Now THAT'S convenience.

You press the button, with a satisfying "click."

*BZZZZZ* ALL THE ALLOYS ARE ALREADY IN THIS ROOM. IF YOU USE ONE UP YOU CAN BRING IT BACK WITH THIS BUTTON!

>rules all
Rules tracing now switched to "all". Type "rules off" to switch it off again.

* * *

>touch button
You softly brush your finger against the button, instead of pushing it. What a tease!
WHAT AN INTERESTING INTERACTION. +5 POINTS!

[Your score has just gone up by five points.]

>touch button
You softly brush your finger against the button, instead of pushing it. What a tease!

>touch button
You softly brush your finger against the button, instead of pushing it. What a tease!

* * *

>lick spark
That's not a verb I recognise.

>taste spark
You taste nothing unexpected.

>eat spark
That's plainly inedible.

* * *

>touch button
You softly brush your finger against the button, instead of pushing it. What a tease!

* * *

 

 

Supply Room
You are standing in a spacious room made of reinforced concrete. A lighting panel illuminates the room in a tense white glow. There is another room to the SOUTH.

An alcove is carved into the wall in front of you. Hovering in the alcove are a SHIELD alloy, a BLADE alloy, an ENTROPIC alloy, a MEND alloy and a SPARK alloy.

A large red button labeled RESUPPLY is mounted above the alcove.

>use mend
(first taking the MEND alloy)

>throw mend
Dropped.

>throw mend at mend
(first taking the MEND alloy)
You throw the MEND alloy at the MEND alloy. Bonk! The MEND alloy lands on the floor.

GOOD THROWING ARM! I DON'T HAVE ARMS, SO THAT'S ESPECIALLY IMPRESSIVE.

[Your score has just gone up by five points.]

* * *

 

 

Supply Room
You are standing in a spacious room made of reinforced concrete. A lighting panel illuminates the room in a tense white glow. There is another room to the SOUTH.

An alcove is carved into the wall in front of you. Hovering in the alcove are a SHIELD alloy, a BLADE alloy, an ENTROPIC alloy, a MEND alloy and a SPARK alloy.

A large red button labeled RESUPPLY is mounted above the alcove.

>use mend alloy
You can't see any such thing.

>use mend
You can't see any such thing.

>take mend
Taken.

>use mend
You can't see any such thing.

* * *

 

 

Supply Room
You are standing in a spacious room made of reinforced concrete. A lighting panel illuminates the room in a tense white glow. There is another room to the SOUTH.

An alcove is carved into the wall in front of you. Hovering in the alcove are a SHIELD alloy, a BLADE alloy, an ENTROPIC alloy, a MEND alloy and a SPARK alloy.

A large red button labeled RESUPPLY is mounted above the alcove.

>use rod
You can't see any such thing.

>abstract rod to me
[Abstracted.]

>use rod
The lightning rod releases a pulse of unstable energy, and you transform into a chicken!

>z
Time passes.

>z
Time passes.

You revert back from being a chicken.
Intern Jim reverts back from being a chicken.
The hostile entity reverts back from being a chicken.

* * *

 

 

Supply Room
You are standing in a spacious room made of reinforced concrete. A lighting panel illuminates the room in a tense white glow. There is another room to the SOUTH.

An alcove is carved into the wall in front of you. Hovering in the alcove are a SHIELD alloy, a BLADE alloy, an ENTROPIC alloy, a MEND alloy and a SPARK alloy.

A large red button labeled RESUPPLY is mounted above the alcove.

>w
You can't go that way.

>s
Combination Station
WELCOME TO THE QUALIFICATION DETERMINATION SIMULATION COMBINATION STATION! HERE YOU CAN TAKE ELEMENTS FROM THE PREVIOUS ROOM AND FORM THEM INTO NEW AND FANCIFUL CREATIONS. WHAT ARE YOU WAITING FOR? LET'S GET CREATIVE!

You are standing in another concrete room. There are exits to the North and South. In the center is a vast machine labeled 'Combinator'. The machine has 3 slots to put elements in:

Slot 1 is empty.

Slot 2 is empty.

Slot 3 is empty.

You can also see a green button labelled GO and Intern Jim here.

* * *

>s
Arena
STUDIES HAVE SHOWN THAT CREATIVITY IS BOOSTED BY 57% UPON THE INTRODUCTION OF A HOSTILE ENTITY! THUS, WE HAVE PROVIDED AN ENEMY FOR YOU TO DEFEAT IN THIS ROOM. PRESS THE BUTTON WHEN YOU FEEL YOU ARE READY TO FIGHT IT!

This is another large, barren concrete room. Exits are to the north and south.

There is a hostile entity trapped by a force field on the other half of the room from you.

The entity grins at you. Well, not so much "grin" as "curl back its lips and roll its eyes back into its head."
.

>attack entity
The entity ripples, as if a giant worm is crawling around just under the surface of its skin.
.

>ask entity about me
GURGLE GURGLE
The entity gurgles softly to itself, and jams a finger into its own eye.
.

>look
Arena

This is another large, barren concrete room. Exits are to the north and south.

There is a hostile entity trapped by a force field on the other half of the room from you.

The entity stares at you. You feel a dull ache in the base of your spine.
.

>n
Combination Station

You are standing in another concrete room. There are exits to the North and South. In the center is a vast machine labeled 'Combinator'. The machine has 3 slots to put elements in:

Slot 1 is empty.

Slot 2 is empty.

Slot 3 is empty.

You can also see a green button labelled GO and Intern Jim here.

>s
Arena

This is another large, barren concrete room. Exits are to the north and south.

There is a hostile entity trapped by a force field on the other half of the room from you.

The entity sucks in air, its ribcabe jutting out as its torso compresses into an impossible skinniness.
.

* * *

>x
(the table)
On the table is a mouse.

THAT table IS NOT SCENERY

>x table
On the table is a mouse.

THAT table IS NOT BUTTS

>x table
On the table is a mouse.

THAT table IS NOT GUYS

>x table
On the table is a mouse.

THAT table IS NOT THINGS

>x table
On the table is a mouse.

THAT table IS NOT THINGS

* * *

 

 

Supply Room
You are standing in a spacious room made of reinforced concrete. A lighting panel illuminates the room in a tense white glow. There is another room to the SOUTH.

An alcove is carved into the wall in front of you. Hovering in the alcove are a SHIELD alloy, a BLADE alloy, an ENTROPIC alloy, a MEND alloy and a SPARK alloy.

A large red button labeled RESUPPLY is mounted above the alcove.

>x alcove
A rectangular hole is carved out of the stone in front of you. It seems to be where the Alloys respawn if you press the RESET button.

* * *

 

 

Supply Room
You are standing in a spacious room made of reinforced concrete. A lighting panel illuminates the room in a tense white glow. There is another room to the SOUTH.

An alcove is carved into the wall in front of you. Hovering in the alcove are a SHIELD alloy, a BLADE alloy, an ENTROPIC alloy, a MEND alloy and a SPARK alloy.

A large red button labeled RESUPPLY is mounted above the alcove.

>x allou
You can't see any such thing.

>x alloy
Which do you mean, the SHIELD alloy, the BLADE alloy, the ENTROPIC alloy, the MEND alloy or the SPARK alloy?

>x SHIELD
A fist-sized cube of pure SHIELD alloy is hovering in front of you. It seems eager to morph into something useful.

I ADMIRE YOUR INQUISITIVE NATURE!

[Your score has just gone up by five points.]

>x BLADE
A sheet of pure BLADE alloy hovers in front of you, light glinting dangerously off its surface. It seems eager to morph into something sharp.

I ADMIRE YOUR EXPLORATORY NATURE!

[Your score has just gone up by five points.]

>x ENTROPIC
A writhing ball of pure ENTROPY hovers in front of you. It hurts to look at.

I ADMIRE YOUR EXPLORATORY SPIRIT!

[Your score has just gone up by five points.]

>x MEND
A glowing ball of pure MEND alloy hovers serenly in front of you. It seems eager to help.

I ADMIRE YOUR CURIOUSITY!

HELLO AGAIN! I'D LIKE TO INTRODUCE... THE RATINGS MODULE! HUMAN FEEDBACK IS CRUCIAL TO CREATIVITRIX, AND THIS LITTLE GUY IS HERE TO COLLECT IT! I'LL LET HIM TALK:

 Please rate your experience with the CREATIVITRIX QUALIFICATION DETERMINATION SIMULATION thus far:

5 - Excellent

4 - Appealing

3 - Unremarkable

2 - Lackluster

1 - Truly Awful

[Your score has just gone up by five points.]

>4
rate 5 stars
YOU ALREADY RATED THIS ASPECT! THANK YOU FOR YOUR COMMITMENT TO THOROUGH CUSTOMER FEEDBACK.

>rate 1000 stars
YOU ALREADY RATED THIS ASPECT! THANK YOU FOR YOUR COMMITMENT TO THOROUGH CUSTOMER FEEDBACK.

>rate -2 stars
I didn't understand that sentence.

>:(
That's not a verb I recognise.

>ask
What do you want to ask yourself for?

>ask self for kiss
You can't see any such thing.

>rectally insert
That's not a verb I recognise.

>damn
That's not a verb I recognise.

>fuck
That's not a verb I recognise.

>ass
That's not a verb I recognise.

>shit
That's not a verb I recognise.

>piss
That's not a verb I recognise.

>z
Time passes.

>uh
That's not a verb I recognise.

>l
Supply Room
You are standing in a spacious room made of reinforced concrete. A lighting panel illuminates the room in a tense white glow. There is another room to the south.

An alcove is carved into the wall in front of you. Hovering in the alcove are a SHIELD alloy, a BLADE alloy, an ENTROPIC alloy, a MEND alloy and a SPARK alloy.

A large red button labeled RESUPPLY is mounted above the alcove.

* * *

>:(
That's not a verb I recognise.

>take MEND alloy
Test this
Taken.

>x panel
rate 1 stars
OH NO! THE RATING MODULE IS DEVASTATED BY YOUR TERRIBLE REVIEW! IT SAYS IT'S SORRY FOR ANNOYING YOU WITH SO MANY RATING REQUESTS... THAT WAS ITS ONLY JOB, IT JUST GOT SO EXCITED! THE RATING MODULE RAN AWAY CRYING.

>apologize
That's not a verb I recognise.

>smile
That's not a verb I recognise.

>wave
You wave.

>yell
That's not a verb I recognise.

>cry
That's not a verb I recognise.

>l
Supply Room
You are standing in a spacious room made of reinforced concrete. A lighting panel illuminates the room in a tense white glow. There is another room to the south.

An alcove is carved into the wall in front of you. Hovering in the alcove are a SHIELD alloy, a BLADE alloy, an ENTROPIC alloy and a SPARK alloy.

A large red button labeled RESUPPLY is mounted above the alcove.

>kill shield alloy
Violence isn't the answer to this one.

>kiss shield alloy
You can only do that to something animate.

>kiss papyrus
You can't see any such thing.

>i
You are carrying:
  a MEND alloy

>take shield alloy
Test 
Taken.

>combine mend and shield
I only understood you as far as wanting to combine.

>comine mend alloy and shield alloy
That's not a verb I recognise.

>combine
There's 3 free slots and you are only carrying 2 alloys. Go take another and try again!

>s
Combination Station
WELCOME TO THE QUALIFICATION DETERMINATION SIMULATION COMBINATION STATION! HERE YOU CAN TAKE ELEMENTS FROM THE PREVIOUS ROOM AND FORM THEM INTO NEW AND FANCIFUL CREATIONS. WHAT ARE YOU WAITING FOR? LET'S GET CREATIVE!

You are standing in another concrete room. There are exits to the North and South. In the center is a vast machine labeled 'Combinator'. The machine has 3 slots to put elements in:

Slot 1 is empty.

Slot 2 is empty.

Slot 3 is empty.

You can also see a green button labelled GO here.

>n
Supply Room
You are standing in a spacious room made of reinforced concrete. A lighting panel illuminates the room in a tense white glow. There is another room to the south.

An alcove is carved into the wall in front of you. Hovering in the alcove are a BLADE alloy, an ENTROPIC alloy and a SPARK alloy.

A large red button labeled RESUPPLY is mounted above the alcove.

>l
Supply Room
You are standing in a spacious room made of reinforced concrete. A lighting panel illuminates the room in a tense white glow. There is another room to the south.

An alcove is carved into the wall in front of you. Hovering in the alcove are a BLADE alloy, an ENTROPIC alloy and a SPARK alloy.

A large red button labeled RESUPPLY is mounted above the alcove.

>s
Combination Station

You are standing in another concrete room. There are exits to the North and South. In the center is a vast machine labeled 'Combinator'. The machine has 3 slots to put elements in:

Slot 1 is empty.

Slot 2 is empty.

Slot 3 is empty.

You can also see a green button labelled GO here.

>put sheild in slot 1
You can't see any such thing.

>put sheild alloy in slot 1
You can't see any such thing.

>put shield alloy in slot 1
You put the SHIELD alloy into slot 1.

>i
You are carrying:
  a MEND alloy

>put mend alloy in slot 2
You put the MEND alloy into slot 2.

>press button
You can't press GO if there's an empty slot!

>fuck you
That's not a verb I recognise.

>n
Supply Room
You are standing in a spacious room made of reinforced concrete. A lighting panel illuminates the room in a tense white glow. There is another room to the south.

An alcove is carved into the wall in front of you. Hovering in the alcove are a BLADE alloy, an ENTROPIC alloy and a SPARK alloy.

A large red button labeled RESUPPLY is mounted above the alcove.

>take spark alloy
Test 
Taken.

>s
Combination Station

You are standing in another concrete room. There are exits to the North and South. In the center is a vast machine labeled 'Combinator'. The machine has 3 slots to put elements in:

Slot 1 contains a SHIELD alloy.

Slot 2 contains a MEND alloy.

Slot 3 is empty.

You can also see a green button labelled GO here.

>put spark alloy in slot 3
You put the SPARK alloy into slot 3.

>press button
Ingredient list: MEND alloy, SHIELD alloy and SPARK alloy

The SHIELD and MELD elements combine to form a magical helmet, and the SPARK alloy makes itself busy by creating a system that diagnoses and heals your wounds. Neat!

AMAZING! THAT'S AN INCREDIBLE HEALING HELMET YOU'VE JUST CREATED! I'M AWARDING YOU 20 CREATIVITY POINTS FOR IT.

[Your score has just gone up by twenty points.]

>take helmet
You already have that.

>i
You are carrying:
  a healing helmet

>put on helmet
You can't wear that!

>why
That's not a verb I recognise.

>well, whatever
You seem to want to talk to someone, but I can't see whom.

>well
That's not a verb I recognise.

>whatever
That's not a verb I recognise.

>,
You can't begin with a comma.

>w,w
You can't go that way.

You can't go that way.

>w,w,w,w,w,w,w,s,s,s,s,s,
You can't go that way.

You can't go that way.

You can't go that way.

You can't go that way.

You can't go that way.

You can't go that way.

You can't go that way.

You can't go that way.

You can't go that way.

You can't go that way.

You can't go that way.

You can't go that way.

>lol
That's not a verb I recognise.

>n
Supply Room
You are standing in a spacious room made of reinforced concrete. A lighting panel illuminates the room in a tense white glow. There is another room to the south.

An alcove is carved into the wall in front of you. Hovering in the alcove are a BLADE alloy and an ENTROPIC alloy.

A large red button labeled RESUPPLY is mounted above the alcove.

>jump
You jump on the spot.

>pose
That's not a verb I recognise.

>(
That's not a verb I recognise.

>abstract all
(to the healing helmet)
[Can't move healing helmet: it would contain itself.]
[Abstracted.]
[Abstracted.]
[Can't move Supply Room: it would contain itself.]
[Abstracted.]
[Abstracted.]
[Abstracted.]
[Abstracted.]
[Abstracted.]
[Abstracted.]
[Abstracted.]
[Abstracted.]
[Abstracted.]
[Abstracted.]
[Abstracted.]
[Abstracted.]
[Abstracted.]
[Abstracted.]
[Abstracted.]
[Abstracted.]
[Abstracted.]
[Abstracted.]
[Abstracted.]
[Abstracted.]
[Abstracted.]
[Abstracted.]
[Abstracted.]
[Abstracted.]
[Abstracted.]
[Abstracted.]
[Abstracted.]
[Abstracted.]
[Abstracted.]
[Abstracted.]
[Abstracted.]
[Abstracted.]
[Abstracted.]
[Abstracted.]
[Abstracted.]
[Abstracted.]
[Abstracted.]

>l
Supply Room
You are standing in a spacious room made of reinforced concrete. A lighting panel illuminates the room in a tense white glow. There is another room to the south.

>i
You are carrying:
  a healing helmet

>l
Supply Room
You are standing in a spacious room made of reinforced concrete. A lighting panel illuminates the room in a tense white glow. There is another room to the south.

>l
Supply Room
You are standing in a spacious room made of reinforced concrete. A lighting panel illuminates the room in a tense white glow. There is another room to the south.

>take all
There are none at all available!

>oops
Think nothing of it.

>undo
Supply Room
[Previous turn undone.]

>undo
Supply Room
[Previous turn undone.]

>undo
"Undo" capacity exhausted. Sorry!

>l
Supply Room
You are standing in a spacious room made of reinforced concrete. A lighting panel illuminates the room in a tense white glow. There is another room to the south.

An alcove is carved into the wall in front of you. Hovering in the alcove are a BLADE alloy and an ENTROPIC alloy.

A large red button labeled RESUPPLY is mounted above the alcove.

>i
You are carrying:
  a healing helmet

>push button
A SHIELD alloy teleports in!
A MEND alloy zaps in!
A SPARK alloy warps in!

>kill self
Violence isn't the answer to this one.

>x alcove
A rectangular hole is carved out of the stone in front of you. It seems to be where the Alloys respawn if you press the RESET button.

On the alcove are a SPARK alloy, a MEND alloy and a SHIELD alloy.

I ADMIRE YOUR INTEREST IN YOUR ENVIRONMENT!

[Your score has just gone up by five points.]

>l
Supply Room
You are standing in a spacious room made of reinforced concrete. A lighting panel illuminates the room in a tense white glow. There is another room to the south.

An alcove is carved into the wall in front of you. Hovering in the alcove are a SPARK alloy, a MEND alloy, a SHIELD alloy, a BLADE alloy and an ENTROPIC alloy.

A large red button labeled RESUPPLY is mounted above the alcove.

>take spark, mend, and entropic alloy
You can't see any such thing.

>take spark, mend, and entropic
You can't see any such thing.

>take spark, mend, entropic
SPARK alloy: Test 
Taken.
MEND alloy: Test 
Taken.
ENTROPIC alloy: Test 
Taken.

>combine
Combination Station

You are standing in another concrete room. There are exits to the North and South. In the center is a vast machine labeled 'Combinator'. The machine has 3 slots to put elements in:

Slot 1 is empty.

Slot 2 is empty.

Slot 3 is empty.

You can also see a green button labelled GO here.

You put the ENTROPIC alloy into slot 1.

Slot 1 is full, so let's put MEND alloy in slot 2. You put the MEND alloy into slot 2.

Slot 1 is full, so let's put SPARK alloy in slot 2. Slot 2 is full, so let's put SPARK alloy in slot 3. You put the SPARK alloy into slot 3.

>x machine
An indecipherable structure made of whirring cogs and gnashing machinery. It's name is the "Combinator", according to a small plaque affixed to the side. It has 3 slots to put elements in, and a large green button labelled "GO".

I ADMIRE YOUR CURIOUSITY!

[Your score has just gone up by five points.]

>ask combinator about me
You can't see any such thing.

>ok
That's not a verb I recognise.

>ask machine
You can only do that to something animate.

>x plaque
A small plaque attached to the side of the machine. It says "Combinator" in a pleasing Arial font.

I ADMIRE YOUR INTEREST IN YOUR ENVIRONMENT!

[Your score has just gone up by five points.]

>x slot 1
In slot 1 is an ENTROPIC alloy.

I ADMIRE YOUR EXPLORATORY NATURE!

[Your score has just gone up by five points.]

>x slot 2
In slot 2 is a MEND alloy.

I ADMIRE YOUR CURIOUSITY!

[Your score has just gone up by five points.]

>x slot 3
In slot 3 is a SPARK alloy.

I ADMIRE YOUR INQUISITIVE NATURE!

[Your score has just gone up by five points.]

>press btton
You can't see any such thing.

>lol
That's not a verb I recognise.

>press button
Ingredient list: ENTROPIC alloy, MEND alloy and SPARK alloy

The ENTROPIC and MELD alloys react violently with one another, and the SPARK alloy struggles to contain them! Eventually it coalesces into a rod that sparks and surges with unstable energy.

AMAZING! THAT'S AN INCREDIBLE LIGHTNING ROD YOU'VE JUST CREATED! I'M AWARDING YOU 20 CREATIVITY POINTS FOR IT.

[Your score has just gone up by twenty points.]

>take rod
You already have that.

>l
Combination Station

You are standing in another concrete room. There are exits to the North and South. In the center is a vast machine labeled 'Combinator'. The machine has 3 slots to put elements in:

Slot 1 is empty.

Slot 2 is empty.

Slot 3 is empty.

You can also see a green button labelled GO here.

>i
You are carrying:
  a lightning rod
  a healing helmet

>x rod
Sparks fly from this unpredictable weapon - who knows what it might do in battle?

I ADMIRE YOUR EXPLORATORY NATURE!

[Your score has just gone up by five points.]

>equip rod
That's not a verb I recognise.

>n
Supply Room
You are standing in a spacious room made of reinforced concrete. A lighting panel illuminates the room in a tense white glow. There is another room to the south.

An alcove is carved into the wall in front of you. Hovering in the alcove are a SHIELD alloy and a BLADE alloy.

A large red button labeled RESUPPLY is mounted above the alcove.

>attack screen with rod
You can't see any such thing.

>throw rod at screen
You can't see any such thing.

>throw rod at panel
Futile.

>oh fuck
That's not a verb I recognise.

>go to Dumb Workaround
You can't see any such thing.

>that sucks
That's not a verb I recognise.

* * *

 

 

Supply Room
You are standing in a spacious room made of reinforced concrete. A lighting panel illuminates the room in a tense white glow. There is another room to the SOUTH.

An alcove is carved into the wall in front of you. Hovering in the alcove are a SHIELD alloy, a BLADE alloy, an ENTROPIC alloy, a MEND alloy and a SPARK alloy.

A large red button labeled RESUPPLY is mounted above the alcove.

>x alloy
Which do you mean, the BLADE alloy, the ENTROPIC alloy, the SALVE alloy, the SPARK alloy or the SHIELD alloy?

>x blade
You see nothing special about the BLADE alloy.

>x shield
You see nothing special about the SHIELD alloy.

>x
What do you want to examine?

>x room
You can't see any such thing.

>z
Time passes.

>look
Workshop
You are standing in a room made of reinforced concrete. lighting panel illuminates the room in a tense white glow. A curious shelf is inset into the concrete in front of you.

The shelf has  are a BLADE alloy, an ENTROPIC alloy, a SALVE alloy, a SPARK alloy and a SHIELD alloy.

* * *

 

 

Supply Room
You are standing in a spacious room made of reinforced concrete. A lighting panel illuminates the room in a tense white glow. There is another room to the SOUTH.

An alcove is carved into the wall in front of you. Hovering in the alcove are a SHIELD alloy, a BLADE alloy, an ENTROPIC alloy, a MEND alloy and a SPARK alloy.

A large red button labeled RESUPPLY is mounted above the alcove.

>x button
A glowing red button. PRESS THIS BUTTON IF YOU NEED MORE ALLOYS.

I ADMIRE YOUR INQUISITIVE NATURE!

[Your score has just gone up by five points.]

>x button
A glowing red button. PRESS THIS BUTTON IF YOU NEED MORE ALLOYS.

>x button
A glowing red button. PRESS THIS BUTTON IF YOU NEED MORE ALLOYS.

I ADMIRE YOUR EXPLORATORY SPIRIT!

[Your score has just gone up by five points.]

* * *

 

 

Supply Room
You are standing in a spacious room made of reinforced concrete. A lighting panel illuminates the room in a tense white glow. There is another room to the SOUTH.

An alcove is carved into the wall in front of you. Hovering in the alcove are a SHIELD alloy, a BLADE alloy, an ENTROPIC alloy, a MEND alloy and a SPARK alloy.

A large red button labeled RESUPPLY is mounted above the alcove.

>x door
A rectangular passage carved out of the concrete leads to another room to the south.

>x south
You see nothing unexpected in that direction.

>x north
You see nothing unexpected in that direction.

>go south
Combination Station
You can see a Combinator here.

* * *

 

 

Supply Room
You are standing in a spacious room made of reinforced concrete. A lighting panel illuminates the room in a tense white glow. There is another room to the SOUTH.

An alcove is carved into the wall in front of you. Hovering in the alcove are a SHIELD alloy, a BLADE alloy, an ENTROPIC alloy, a MEND alloy and a SPARK alloy.

A large red button labeled RESUPPLY is mounted above the alcove.

>x hole
A rectangular hole is carved out of the stone in front of you. It seems to be where the Alloys respawn if you press the RESET button.

* * *

 

 

Supply Room
You are standing in a spacious room made of reinforced concrete. A lighting panel illuminates the room in a tense white glow. There is another room to the SOUTH.

An alcove is carved into the wall in front of you. Hovering in the alcove are a SHIELD alloy, a BLADE alloy, an ENTROPIC alloy, a MEND alloy and a SPARK alloy.

A large red button labeled RESUPPLY is mounted above the alcove.

>x light
You see nothing special about lighting.

* * *

 

 

Supply Room
You are standing in a spacious room made of reinforced concrete. A lighting panel illuminates the room in a tense white glow. There is another room to the SOUTH.

An alcove is carved into the wall in front of you. Hovering in the alcove are a SHIELD alloy, a BLADE alloy, an ENTROPIC alloy, a MEND alloy and a SPARK alloy.

A large red button labeled RESUPPLY is mounted above the alcove.

>x red
A glowing red button. PRESS THIS BUTTON IF YOU NEED MORE ALLOYS.

>x labeled
A glowing red button. PRESS THIS BUTTON IF YOU NEED MORE ALLOYS.

>x large
A glowing red button. PRESS THIS BUTTON IF YOU NEED MORE ALLOYS.

>look
Workshop
You are standing in a spacious room made of reinforced concrete. A lighting panel illuminates the room in a tense white glow.

An alcove is carved into the wall in front of you. Hovering in the alcove are a SHIELD alloy, a BLADE alloy, an ENTROPIC alloy, a SALVE alloy and a SPARK alloy.

A large red button labeled RESUPPLY is mounted above the alcove.

* * *

 

 

Supply Room
You are standing in a spacious room made of reinforced concrete. A lighting panel illuminates the room in a tense white glow. There is another room to the SOUTH.

An alcove is carved into the wall in front of you. Hovering in the alcove are a SHIELD alloy, a BLADE alloy, an ENTROPIC alloy, a MEND alloy and a SPARK alloy.

A large red button labeled RESUPPLY is mounted above the alcove.

>x shelf
On the shelf are a BLADE alloy, an ENTROPIC alloy, a SALVE alloy and a SPARK alloy.

>x shelf
On the shelf are a BLADE alloy, an ENTROPIC alloy, a SALVE alloy and a SPARK alloy.

* * *

 

 

Supply Room
You are standing in a spacious room made of reinforced concrete. A lighting panel illuminates the room in a tense white glow. There is another room to the SOUTH.

An alcove is carved into the wall in front of you. Hovering in the alcove are a SHIELD alloy, a BLADE alloy, an ENTROPIC alloy, a MEND alloy and a SPARK alloy.

A large red button labeled RESUPPLY is mounted above the alcove.

>x shield
A fist-sized cube of pure SHIELD alloy is hovering in front of you. It seems eager to morph into something useful.

I ADMIRE YOUR INQUISITIVE NATURE!

[Your score has just gone up by five points.]

>x blade
A sheet of pure BLADE alloy hovers in front of you, light glinting dangerously off its surface. It seems eager to morph into something sharp.

I ADMIRE YOUR EXPLORATORY NATURE!

[Your score has just gone up by five points.]

>taste blade
You gingerly move to lick the BLADE alloy. Ow! It smacks your face with its flat side.

EXCELLENT! BE SURE TO INSPECT YOUR ENVIRONMENT CAREFULLY!

[Your score has just gone up by five points.]

>eat blade
You gingerly move to lick the BLADE alloy. Ow! It smacks your face with its flat side.

>throw blade at light
(first taking the BLADE alloy)
The lighting panel is unfazed by your attempts to bring it off its high horse.

HUMAN, WHAT DID THAT LIGHT EVER DO TO YOU?

You throw the BLADE alloy at the lighting panel. Bonk! The BLADE alloy lands on the floor.

GOOD THROWING ARM! I DON'T HAVE ARMS, SO THAT'S ESPECIALLY IMPRESSIVE.

[Your score has just gone up by five points.]

>look light
A flat white panel is embedded in the concrete on the ceiling. It glows with a uniform brightness.

I ADMIRE YOUR EXPLORATORY SPIRIT!

[Your score has just gone up by five points.]

>smell light
You sniff as hard as you can, trying to get the scent of the panel. Your eyes water.

EXCELLENT! BE SURE TO INSPECT YOUR ENVIRONMENT CAREFULLY!

[Your score has just gone up by five points.]

>sniff light
You sniff as hard as you can, trying to get the scent of the panel. Your eyes water.

>snort mend
That's not a verb I recognise.

>sniff mend
The soothing scent of lavender washes over you. You close your eyes and enjoy it for a moment.

AMAZING! YOUR SNIFFING ABILITIES ARE UNPARALLELED.

[Your score has just gone up by five points.]

>listen
What do you want to listen?

>listen me
You hear the soft hum of Air Conditioning.

>listen me
You hear a distant refrigerator running.

>listen me
You hear a cheap cricket sound effect from far off in the distance.

>listen me
You hear someone whisper "Nyeh heh heh!"

>listen me
You hear the sound of your own heartbeat.

>listen me
You hear the sound of your own breathing.

>listen me
You hear the sound of a clanking machine somewhere.

>listen me
You don't hear anything in particular.

>listen me
You hear the sounds of the universe.

>listen me
You hear the earth moving.

>listen me
You hear the narrator telling you what you're hearing.

>listen to men
You can't see any such thing.

>listen to blade
You hear computation.

>listen to blade
You hear silence.

>listen to blade
You hear the narrator sigh to himself.

>listen to blade
You hear a distant refrigerator running.

>listen to blade
You hear the narrator sigh to himself.

>listen to blade
You hear the soft hum of Air Conditioning.

>listen to blade
You hear someone whisper "Nyeh heh heh!"

>look
Supply Room
You are standing in a spacious room made of reinforced concrete. A lighting panel illuminates the room in a tense white glow. There is another room to the south.

An alcove is carved into the wall in front of you. Hovering in the alcove are a SHIELD alloy, an ENTROPIC alloy, a MEND alloy and a SPARK alloy.

A large red button labeled RESUPPLY is mounted above the alcove.

>take shield entropic
I only understood you as far as wanting to take the SHIELD alloy.

>take all
You should only take 3 elements at a time - that's how many you can

>take shield, entropic and mend
SHIELD alloy: Taken.
ENTROPIC alloy: Taken.
MEND alloy: Taken.

>combine
Combination Station
WELCOME TO THE QUALIFICATION DETERMINATION SIMULATION COMBINATION STATION! HERE YOU CAN TAKE ELEMENTS FROM THE PREVIOUS ROOM AND FORM THEM INTO NEW AND FANCIFUL CREATIONS. WHAT ARE YOU WAITING FOR? LET'S GET CREATIVE!

You are standing in another concrete room. There are exits to the North and South. In the center is a vast machine labeled 'Combinator'. The machine has 3 slots to put elements in:

Slot 1 is empty.

Slot 2 is empty.

Slot 3 is empty.

You can also see a green button labelled GO and Intern Jim here.

You walk to the Combination Station.

You put the SHIELD alloy into slot 1.

Slot 1 is full, so let's put ENTROPIC alloy in slot 2. You put the ENTROPIC alloy into slot 2.

Slot 1 is full, so let's put MEND alloy in slot 2. Slot 2 is full, so let's put MEND alloy in slot 3. You put the MEND alloy into slot 3.

>ask intern jim about entropy
Jim looks uncomfortable. "Entropy... They say that even storing information about it is a vector for it to infect you. All we know is that Entropy has destroyed a lot of civilization. We don't know where it is, what it is, what it wants, or anything... It's even dangerous just to have this Entropy in the simulation."

>ask intern jim about me
"You're an applicant for Creativitrix! Keep pumping out creativity and you'll be an endpoint in no time."

>ask intern jim about simulation
"You want to know about the Creativitrix? Well, it's simple. As you can probably tell, AI these days is really good at computing and simulating, but is terrible at coming up with original ideas! I mean, the name of this thing is just CREATIVITY plus MATRIX for crying out loud. If you're creative enough, you can sign up as an Endpoint and help come up with original ideas for the AI.

>ask intern jim about you
"Oh, I'm just an Artificially Intelligent intern. Feel free to order me around, test weapons on me..."

 He notices your confused expression.

 "I'll regenerate if you do any real harm. Fire away!"

>ask intern jim about room
Jim nods politely, but clearly doesn't have any idea what you're talking about.

* * *

 

 

Supply Room
You are standing in a spacious room made of reinforced concrete. A lighting panel illuminates the room in a tense white glow. There is another room to the SOUTH.

An alcove is carved into the wall in front of you. Hovering in the alcove are a SHIELD alloy, a BLADE alloy, an ENTROPIC alloy, a MEND alloy and a SPARK alloy.

A large red button labeled RESUPPLY is mounted above the alcove.

>x spark
A bright ball of pure SPARK alloy flits in front of you. It seems impatient for you to make something out of it

>x blade
A sheet of pure BLADE alloy hovers in front of you, light glinting dangerously off its surface. It seems eager to morph into something sharp.

>x alcove
You see nothing special about the alcove.

* * *

 

 

Supply Room
You are standing in a spacious room made of reinforced concrete. A lighting panel illuminates the room in a tense white glow. There is another room to the SOUTH.

An alcove is carved into the wall in front of you. Hovering in the alcove are a SHIELD alloy, a BLADE alloy, an ENTROPIC alloy, a MEND alloy and a SPARK alloy.

A large red button labeled RESUPPLY is mounted above the alcove.

>x stuff
You can't see any such thing.

* * *

 

 

Supply Room
You are standing in a spacious room made of reinforced concrete. A lighting panel illuminates the room in a tense white glow. There is another room to the SOUTH.

An alcove is carved into the wall in front of you. Hovering in the alcove are a SHIELD alloy, a BLADE alloy, an ENTROPIC alloy, a MEND alloy and a SPARK alloy.

A large red button labeled RESUPPLY is mounted above the alcove.

>x table
On the table are a mouse and DUMB STUFF LOL.

WHAT A COOL TABLE

>eat table
That's plainly inedible.

>eat mouse
That's plainly inedible.

>eat lighting
That's plainly inedible.

>taste lighting
You taste nothing unexpected.

>taste lights
You can't see any such thing.

* * *

>x table
On the table are a mouse and DUMB STUFF LOL.

WHAT A COOL TABLE

>take DUMB
You can't see any such thing.

>take thing
WHOO BOY
WHAT A COOL TABLE

>inv
You are carrying:
  DUMB STUFF LOL

WHOO BOY
WHAT A COOL TABLE

* * *

>x table
On the table are a mouse and DUMB STUFF LOL.

WHAT A COOL TABLE

>x mouse
You see nothing special about the mouse.

WHAT A COOL TABLE

>actions
Actions listing on.

* * *

>rules
Rules tracing now switched on. Type "rules off" to switch it off again, or "rules all" to include even rules which do not apply.

>x table
[Rule "redirect to GEP line input rule" applies.]
[Rule "ordinary checking for content rule" applies.]
[Rule "declare everything initially unmentioned rule" applies.]
[examining the table]
[Rule "announce items from multiple object lists rule" applies.]
[Rule "set pronouns from items from multiple object lists rule" applies.]
[Rule "before stage rule" applies.]
[Rule "can't act in the dark rule" applies.]
[Rule "instead stage rule" applies.]
[Rule "investigate player's awareness before action rule" applies.]
[Rule "player aware of his own actions rule" applies.]
[Rule "check stage rule" applies.]
[Rule "carry out stage rule" applies.]
[Rule "standard examining rule" applies.]
[Rule "examine directions rule" applies.]
[Rule "examine containers rule" applies.]
[Rule "examine supporters rule" applies.]
On the table are a mouse and DUMB STUFF LOL.

[Rule "examine devices rule" applies.]
[Rule "examine undescribed things rule" applies.]
[Rule "after stage rule" applies.]
[Rule "After examining a thing that is not scenery ( called inspectee )" applies.]
THAT table IS NOT GUYS[examining the table - succeeded]

[Rule "A first turn sequence rule" applies.]
[Rule "every turn stage rule" applies.]
[Rule "Every turn when the table is cool" applies.]
WHAT A COOL TABLE
[Rule "A last turn sequence rule" applies.]
[Rule "notify score changes rule" applies.]

* * *

>x mouse
You see nothing special about the mouse.

WHAT A COOL TABLE

>x mouse
You see nothing special about the mouse.

WOW! WHAT A COOL mouse
WHAT A COOL TABLE

>x mouse
You see nothing special about the mouse.

WOW! WHAT A COOL mouse
WHAT A COOL TABLE

* * *

>x table
On the table are a mouse and DUMB STUFF LOL.

WHAT A COOL TABLE

>x table
On the table are a mouse and DUMB STUFF LOL.

You can't go that way.

>x mouse
You see nothing special about the mouse.

THAT mouse IS NOT GUYS
WHAT A COOL TABLE

>x mouse
You see nothing special about the mouse.

THAT mouse IS NOT THINGS
WHAT A COOL TABLE

* * *

 

 

Supply Room
You are standing in a spacious room made of reinforced concrete. A lighting panel illuminates the room in a tense white glow. There is another room to the SOUTH.

An alcove is carved into the wall in front of you. Hovering in the alcove are a SHIELD alloy, a BLADE alloy, an ENTROPIC alloy, a MEND alloy and a SPARK alloy.

A large red button labeled RESUPPLY is mounted above the alcove.

>yell
THAT'S IT! GET THOSE CREATIVE JUICES FLOWING!

>jump
EXCERSIZING REGULARLY IS KEY TO CREATIVITY! KEEP IT UP!

>run in place
You can't see any such thing.

>run button
That's not something you can enter.

>s
Combination Station
WELCOME TO THE QUALIFICATION DETERMINATION SIMULATION COMBINATION STATION! HERE YOU CAN TAKE ELEMENTS FROM THE PREVIOUS ROOM AND FORM THEM INTO NEW AND FANCIFUL CREATIONS. WHAT ARE YOU WAITING FOR? LET'S GET CREATIVE!

You are standing in another concrete room. There are exits to the North and South. In the center is a vast machine labeled 'Combinator'. The machine has 3 slots to put elements in:

Slot 1 is empty.

Slot 2 is empty.

Slot 3 is empty.

You can also see a green button labelled GO and Intern Jim here.

>jim, attack jim
FINALLY
Intern Jim is unable to do that.

>rules all
Rules tracing now switched to "all". Type "rules off" to switch it off again.

>jim, attack jim
[Rule "debounce arrange event rule" does not apply (wrong action).]
[Rule "redirect to GEP timed activity rule" does not apply (wrong action).]
[Rule "redirect to GEP character input rule" does not apply (wrong action).]
[Rule "redirect to GEP line input rule" applies.]
[Rule "redirect to GEP mouse input rule" does not apply (wrong action).]
[Rule "redirect to GEP arranging rule" does not apply (wrong action).]
[Rule "redirect to GEP redrawing rule" does not apply (wrong action).]
[Rule "redirect to GEP sound notification rule" does not apply (wrong action).]
[Rule "redirect to GEP hyperlink rule" does not apply (wrong action).]
[Rule "ordinary checking for content rule" applies.]
[Rule "After reading a command" applies.]
[Rule "declare everything initially unmentioned rule" applies.]
[Rule "announce items from multiple object lists rule" applies.]
[Rule "set pronouns from items from multiple object lists rule" applies.]
[Rule "before stage rule" applies.]
[Rule "don't ignore the rating module rule" does not apply (wrong action).]
[Rule "instead stage rule" applies.]
[Rule "fightlight rule" does not apply (wrong action).]
[Rule "Instead of attacking someone ( called victim )" does not apply (wrong action).]
[Rule "JIM COME ON rule" does not apply (wrong action).]
[Rule "Persuasion rule for asking Jim to try doing something" applies.]
[Rule "announce items from multiple object lists rule" applies.]
[Rule "set pronouns from items from multiple object lists rule" applies.]
[Rule "before stage rule" applies.]
[Rule "don't ignore the rating module rule" does not apply (wrong action).]
[Rule "instead stage rule" applies.]
[Rule "fightlight rule" does not apply (wrong action).]
[Rule "Instead of attacking someone ( called victim )" does not apply (wrong action).]
[Rule "JIM COME ON rule" applies.]
FINALLY
Intern Jim is unable to do that.

[Rule "A first turn sequence rule" applies.]
[Rule "every turn stage rule" applies.]
[Rule "Every turn when the entity is not cubed and location is Arena" does not apply (wrong context).]
[Rule "Every turn when the entity is cubed and the location is the Arena" does not apply (wrong context).]
[Rule "A last turn sequence rule" applies.]
[Rule "notify score changes rule" applies.]

>actions
[Rule "debounce arrange event rule" does not apply (wrong action).]
[Rule "redirect to GEP timed activity rule" does not apply (wrong action).]
[Rule "redirect to GEP character input rule" does not apply (wrong action).]
[Rule "redirect to GEP line input rule" applies.]
[Rule "redirect to GEP mouse input rule" does not apply (wrong action).]
[Rule "redirect to GEP arranging rule" does not apply (wrong action).]
[Rule "redirect to GEP redrawing rule" does not apply (wrong action).]
[Rule "redirect to GEP sound notification rule" does not apply (wrong action).]
[Rule "redirect to GEP hyperlink rule" does not apply (wrong action).]
[Rule "ordinary checking for content rule" applies.]
[Rule "After reading a command" applies.]
[Rule "declare everything initially unmentioned rule" applies.]
Actions listing on.

>jim, attack jim
[Rule "debounce arrange event rule" does not apply (wrong action).]
[Rule "redirect to GEP timed activity rule" does not apply (wrong action).]
[Rule "redirect to GEP character input rule" does not apply (wrong action).]
[Rule "redirect to GEP line input rule" applies.]
[Rule "redirect to GEP mouse input rule" does not apply (wrong action).]
[Rule "redirect to GEP arranging rule" does not apply (wrong action).]
[Rule "redirect to GEP redrawing rule" does not apply (wrong action).]
[Rule "redirect to GEP sound notification rule" does not apply (wrong action).]
[Rule "redirect to GEP hyperlink rule" does not apply (wrong action).]
[Rule "ordinary checking for content rule" applies.]
[Rule "After reading a command" applies.]
[Rule "declare everything initially unmentioned rule" applies.]
[asking Intern Jim to try attacking Intern Jim]
[Rule "announce items from multiple object lists rule" applies.]
[Rule "set pronouns from items from multiple object lists rule" applies.]
[Rule "before stage rule" applies.]
[Rule "don't ignore the rating module rule" does not apply (wrong action).]
[Rule "instead stage rule" applies.]
[Rule "fightlight rule" does not apply (wrong action).]
[Rule "Instead of attacking someone ( called victim )" does not apply (wrong action).]
[Rule "JIM COME ON rule" does not apply (wrong action).]
[Rule "Persuasion rule for asking Jim to try doing something" applies.]
[(1) Intern Jim attacking Intern Jim]
[Rule "announce items from multiple object lists rule" applies.]
[Rule "set pronouns from items from multiple object lists rule" applies.]
[Rule "before stage rule" applies.]
[Rule "don't ignore the rating module rule" does not apply (wrong action).]
[Rule "instead stage rule" applies.]
[Rule "fightlight rule" does not apply (wrong action).]
[Rule "Instead of attacking someone ( called victim )" does not apply (wrong action).]
[Rule "JIM COME ON rule" applies.]
FINALLY[(1) Intern Jim attacking Intern Jim - failed]

Intern Jim is unable to do that.

[asking Intern Jim to try attacking Intern Jim - succeeded]

[Rule "A first turn sequence rule" applies.]
[Rule "every turn stage rule" applies.]
[Rule "Every turn when the entity is not cubed and location is Arena" does not apply (wrong context).]
[Rule "Every turn when the entity is cubed and the location is the Arena" does not apply (wrong context).]
[Rule "A last turn sequence rule" applies.]
[Rule "notify score changes rule" applies.]

>jim, attack jim
[Rule "debounce arrange event rule" does not apply (wrong action).]
[Rule "redirect to GEP timed activity rule" does not apply (wrong action).]
[Rule "redirect to GEP character input rule" does not apply (wrong action).]
[Rule "redirect to GEP line input rule" applies.]
[Rule "redirect to GEP mouse input rule" does not apply (wrong action).]
[Rule "redirect to GEP arranging rule" does not apply (wrong action).]
[Rule "redirect to GEP redrawing rule" does not apply (wrong action).]
[Rule "redirect to GEP sound notification rule" does not apply (wrong action).]
[Rule "redirect to GEP hyperlink rule" does not apply (wrong action).]
[Rule "ordinary checking for content rule" applies.]
[Rule "After reading a command" applies.]
[Rule "declare everything initially unmentioned rule" applies.]
[asking Intern Jim to try attacking Intern Jim]
[Rule "announce items from multiple object lists rule" applies.]
[Rule "set pronouns from items from multiple object lists rule" applies.]
[Rule "before stage rule" applies.]
[Rule "don't ignore the rating module rule" does not apply (wrong action).]
[Rule "instead stage rule" applies.]
[Rule "fightlight rule" does not apply (wrong action).]
[Rule "Instead of attacking someone ( called victim )" does not apply (wrong action).]
[Rule "JIM COME ON rule" does not apply (wrong action).]
[Rule "Persuasion rule for asking Jim to try doing something" applies.]
[(1) Intern Jim attacking Intern Jim]
[Rule "announce items from multiple object lists rule" applies.]
[Rule "set pronouns from items from multiple object lists rule" applies.]
[Rule "before stage rule" applies.]
[Rule "don't ignore the rating module rule" does not apply (wrong action).]
[Rule "instead stage rule" applies.]
[Rule "fightlight rule" does not apply (wrong action).]
[Rule "Instead of attacking someone ( called victim )" does not apply (wrong action).]
[Rule "JIM COME ON rule" applies.]
FINALLY[(1) Intern Jim attacking Intern Jim - failed]

Intern Jim is unable to do that.

[asking Intern Jim to try attacking Intern Jim - succeeded]

[Rule "A first turn sequence rule" applies.]
[Rule "every turn stage rule" applies.]
[Rule "Every turn when the entity is not cubed and location is Arena" does not apply (wrong context).]
[Rule "Every turn when the entity is cubed and the location is the Arena" does not apply (wrong context).]
[Rule "A last turn sequence rule" applies.]
[Rule "notify score changes rule" applies.]

* * *

>z
Time passes.

>x table
On the table is a mouse.

THAT table IS NOT SCENERY
WHAT A COOL TABLE

>x table
On the table is a mouse.

THAT table IS NOT BUTTS

* * *

>x table
On the table is a mouse.

THAT table IS NOT SCENERY
WHAT A COOL TABLE

>z
rate 5
That's not a verb I recognise.

* * *

>z
Time passes.

>look
Workshop
You are standing in a modern-looking laboratory.

* * *

>z
Time passes.

>x table
On the table are a mouse and DUMB STUFF LOL.

>x
(the light snack)
You see nothing special about the light snack.

>z
Time passes.

>rule
That's not a verb I recognise.

>rules
Rules tracing now switched on. Type "rules off" to switch it off again, or "rules all" to include even rules which do not apply.

>x
[Rule "redirect to GEP line input rule" applies.]
[Rule "ordinary checking for content rule" applies.]
(the light snack)
[Rule "declare everything initially unmentioned rule" applies.]
[Rule "announce items from multiple object lists rule" applies.]
[Rule "set pronouns from items from multiple object lists rule" applies.]
[Rule "before stage rule" applies.]
[Rule "can't act in the dark rule" applies.]
[Rule "instead stage rule" applies.]
[Rule "investigate player's awareness before action rule" applies.]
[Rule "player aware of his own actions rule" applies.]
[Rule "check stage rule" applies.]
[Rule "carry out stage rule" applies.]
[Rule "standard examining rule" applies.]
[Rule "examine directions rule" applies.]
[Rule "examine containers rule" applies.]
[Rule "examine supporters rule" applies.]
[Rule "examine devices rule" applies.]
[Rule "examine undescribed things rule" applies.]
You see nothing special about the light snack.
[Rule "after stage rule" applies.]

[Rule "After examining a thing ( called inspectee )" applies.]
WOW! WHAT A COOL light snack
[Rule "A first turn sequence rule" applies.]
[Rule "every turn stage rule" applies.]
[Rule "A last turn sequence rule" applies.]
[Rule "notify score changes rule" applies.]

>z
[Rule "redirect to GEP line input rule" applies.]
[Rule "ordinary checking for content rule" applies.]
[Rule "declare everything initially unmentioned rule" applies.]
[Rule "announce items from multiple object lists rule" applies.]
[Rule "set pronouns from items from multiple object lists rule" applies.]
[Rule "before stage rule" applies.]
[Rule "instead stage rule" applies.]
[Rule "investigate player's awareness before action rule" applies.]
[Rule "player aware of his own actions rule" applies.]
[Rule "check stage rule" applies.]
[Rule "carry out stage rule" applies.]
[Rule "after stage rule" applies.]
[Rule "investigate player's awareness after action rule" applies.]
[Rule "report stage rule" applies.]
[Rule "standard report waiting rule" applies.]
Time passes.
[Rule "last specific action-processing rule" applies.]

[Rule "A first turn sequence rule" applies.]
[Rule "every turn stage rule" applies.]
[Rule "A last turn sequence rule" applies.]
[Rule "notify score changes rule" applies.]

* * *

>z
Time passes.

>rules all
Rules tracing now switched to "all". Type "rules off" to switch it off again.

>z
[Rule "debounce arrange event rule" does not apply (wrong action).]
[Rule "redirect to GEP timed activity rule" does not apply (wrong action).]
[Rule "redirect to GEP character input rule" does not apply (wrong action).]
[Rule "redirect to GEP line input rule" applies.]
[Rule "redirect to GEP mouse input rule" does not apply (wrong action).]
[Rule "redirect to GEP arranging rule" does not apply (wrong action).]
[Rule "redirect to GEP redrawing rule" does not apply (wrong action).]
[Rule "redirect to GEP sound notification rule" does not apply (wrong action).]
[Rule "redirect to GEP hyperlink rule" does not apply (wrong action).]
[Rule "ordinary checking for content rule" applies.]
[Rule "declare everything initially unmentioned rule" applies.]
[Rule "announce items from multiple object lists rule" applies.]
[Rule "set pronouns from items from multiple object lists rule" applies.]
[Rule "before stage rule" applies.]
[Rule "don't ignore the rating module rule" does not apply (wrong action).]
[Rule "instead stage rule" applies.]
[Rule "investigate player's awareness before action rule" applies.]
[Rule "player aware of his own actions rule" applies.]
[Rule "check stage rule" applies.]
[Rule "carry out stage rule" applies.]
[Rule "after stage rule" applies.]
[Rule "investigate player's awareness after action rule" applies.]
[Rule "report stage rule" applies.]
[Rule "standard report waiting rule" applies.]
Time passes.
[Rule "last specific action-processing rule" applies.]

[Rule "A first turn sequence rule" applies.]
[Rule "every turn stage rule" applies.]
[Rule "first rating happens" applies.]
HELLO AGAIN! I'D LIKE TO INTRODUCE... THE RATINGS MODULE! HUMAN FEEDBACK IS CRUCIAL TO CREATIVITRIX, AND THIS LITTLE GUY IS HERE TO COLLECT IT! I'LL LET HIM TALK:

 Please rate your experience with the CREATIVITRIX QUALIFICATION DETERMINATION SIMULATION thus far:

5 - Excellent

4 - Appealing

3 - Unremarkable

2 - Lackluster

1 - Truly Awful

[Rule "A last turn sequence rule" applies.]
[Rule "notify score changes rule" applies.]

* * *

>z
Time passes.

>z
rate 2 stars
THANK YOU FOR YOUR FEEDBACK!

>rate 0 stars
THANK YOU FOR YOUR FEEDBACK!

>z
Time passes.

>x button
A glowing red button. PRESS THIS BUTTON IF YOU NEED MORE ALLOYS.

THE RATING MODULE IS BACK WITH ANOTHER MESSAGE! ISN'T HE CUTE?

 Please rate the description of the large red button labeled RESUPPLY:

5 - Life changing

4 - Impressive

3 - Mediocre

2 - Trivial

1 - Disgusting

>rate 0 stars
THANK YOU FOR YOUR FEEDBACK!
UH... ACTUALLY LOOKS LIKE THE RATINGS MODULE IS BACK AGAIN WITH ANOTHER RATING! WHAT HAVE YOU GOT TO SAY LITTLE GUY?

 Please rate your experience using the RATING MODULE thus far:

5 - Perfect in every way

4 - Quite good

3 - Meh

2 - Unsatisfactory

1 - Literally painful

* * *

>z
rate 2 stars
THANK YOU FOR YOUR FEEDBACK!

>rate 2.5 stars
I didn't understand that sentence.

>rate 2 stars
THANK YOU FOR YOUR FEEDBACK!

>x button
A glowing red button. PRESS THIS BUTTON IF YOU NEED MORE ALLOYS.

THE RATING MODULE IS BACK WITH ANOTHER MESSAGE! ISN'T HE CUTE?

 Please rate the description of the large red button labeled RESUPPLY:

5 - Life changing

4 - Impressive

3 - Mediocre

2 - Trivial

1 - Disgusting

* * *

>rate 0 stars
THANK YOU FOR YOUR FEEDBACK!
UH... ACTUALLY LOOKS LIKE THE RATINGS MODULE IS BACK AGAIN WITH ANOTHER RATING! WHAT HAVE YOU GOT TO SAY LITTLE GUY?

 Please rate your experience using the RATING MODULE thus far:

5 - Perfect in every way

4 - Quite good

3 - Meh

2 - Unsatisfactory

1 - Literally painful

>rate 0 stars
OH NO! THE RATING MODULE IS DEVASTATED BY YOUR ONE-STAR REVIEW! IT SAYS IT'S SORRY FOR ANNOYING YOU WITH SO MANY RATING REQUESTS... THAT WAS ITS ONLY JOB, IT JUST GOT SO EXCITED! THE RATING MODULE RAN AWAY CRYING.

>touch button
You softly brush your finger against the button, instead of pushing it. What a tease!

I ADMIRE YOUR INQUISITIVE NATURE!

[Your score has just gone up by five points.]

>x button
A glowing red button. PRESS THIS BUTTON IF YOU NEED MORE ALLOYS.

* * *

>z
rate 2 stars
THANK YOU FOR YOUR FEEDBACK!

>rate 5 stars
THANK YOU FOR YOUR FEEDBACK!

I beg your pardon?

* * *

>z
Time passes.

>x button
rate 5 stars
THE RATING MODULE RAN AWAY... IT USUALLY LIKES HIDING DOWN BY THE STRING TABLES IN MAIN MEMORY, SO IT'LL PROBABLY BE FINE. IN THE MEANTIME, HOLD OFF ON RATING ANYTHING.

* * *

>rate 5 stars
THANK YOU FOR YOUR FEEDBACK!

>x button
A glowing red button. PRESS THIS BUTTON IF YOU NEED MORE ALLOYS.

I ADMIRE YOUR INQUISITIVE NATURE!

[Your score has just gone up by five points.]

* * *

>z
rate 2 stars
THANK YOU FOR YOUR FEEDBACK!

>x alloy
Which do you mean, the SHIELD alloy, the BLADE alloy, the ENTROPIC alloy, the MEND alloy or the SPARK alloy?

>x shield
rate 1 stars
THE RATING MODULE RAN AWAY... IT USUALLY LIKES HIDING DOWN BY THE STRING TABLES IN MAIN MEMORY, SO IT'LL PROBABLY BE FINE. IN THE MEANTIME, HOLD OFF ON RATING ANYTHING.

* * *

>z
rate 2 stars
THANK YOU FOR YOUR FEEDBACK!

>x button
rate 1 stars
THE RATING MODULE RAN AWAY... IT USUALLY LIKES HIDING DOWN BY THE STRING TABLES IN MAIN MEMORY, SO IT'LL PROBABLY BE FINE. IN THE MEANTIME, HOLD OFF ON RATING ANYTHING.

>take blae
You can't see any such thing.

>take blade
Test this
Taken.

* * *

>z
rate 2 stars
THANK YOU FOR YOUR FEEDBACK!

>z
YOU'VE GOT TO ANSWER THE RATING MODULE'S QUESTION FIRST! LOOK AT THE POOR LITTLE GUY, ALL HE WANTS TO DO IS HELP!

>look button
rate 2 stars
THANK YOU FOR YOUR FEEDBACK!

>look button
A glowing red button. PRESS THIS BUTTON IF YOU NEED MORE ALLOYS.

THE RATING MODULE IS BACK WITH ANOTHER MESSAGE! ISN'T HE CUTE?:

 Please rate the description of the large red button labeled RESUPPLY:

5 - Life changing

4 - Impressive

3 - Mediocre

2 - Trivial

1 - Disgusting

>look button
A glowing red button. PRESS THIS BUTTON IF YOU NEED MORE ALLOYS.

* * *

>z
YOU'VE GOT TO ANSWER THE RATING MODULE'S QUESTION FIRST! LOOK AT THE POOR LITTLE GUY, ALL HE WANTS TO DO IS HELP!

>s
rate 5 stars
YOU'VE GOT TO ANSWER THE RATING MODULE'S QUESTION FIRST! LOOK AT THE POOR LITTLE GUY, ALL HE WANTS TO DO IS HELP!

* * *

>z
YOU'VE GOT TO ANSWER THE RATING MODULE'S QUESTION FIRST! LOOK AT THE POOR LITTLE GUY, ALL HE WANTS TO DO IS HELP!

>z
Time passes.

>x button
rate 5 stars
OH NO! YOU'VE TERRIFIED THE RATING MODULE WITH YOUR PERFECT SCORE! NOW IT THINKS IT CAN NEVER LIVE UP TO THE GLORY IT'S ACHIEVED FROM YOUR OVERLY PERFECTIONIST RATING. THE RATING MODULE RAN AWAY!

* * *

 

 

Supply Room
You are standing in a spacious room made of reinforced concrete. A lighting panel illuminates the room in a tense white glow. There is another room to the SOUTH.

An alcove is carved into the wall in front of you. Hovering in the alcove are a SHIELD alloy, a BLADE alloy, an ENTROPIC alloy, a MEND alloy and a SPARK alloy.

A large red button labeled RESUPPLY is mounted above the alcove.

>z lighting
I only understood you as far as wanting to wait.

>x lighting
This is some lights.

>x light
This is some lights.

>x lights
You can't see any such thing.

>take mouse
Taken.

>x mouse
You see nothing special about the mouse.

>take table
That's fixed in place.

>x table
You see nothing special about the table.

>smell table
You smell nothing unexpected.

* * *

 

 

Supply Room
You are standing in a spacious room made of reinforced concrete. A lighting panel illuminates the room in a tense white glow. There is another room to the SOUTH.

An alcove is carved into the wall in front of you. Hovering in the alcove are a SHIELD alloy, a BLADE alloy, an ENTROPIC alloy, a MEND alloy and a SPARK alloy.

A large red button labeled RESUPPLY is mounted above the alcove.

>z z z
I only understood you as far as wanting to wait.

>z
Time passes.

>look
Supply Room
You are standing in a spacious room made of reinforced concrete. A lighting panel illuminates the room in a tense white glow. There is another room to the south.

An alcove is carved into the wall in front of you. Hovering in the alcove are a SHIELD alloy, a BLADE alloy, an ENTROPIC alloy, a MEND alloy and a SPARK alloy.

A large red button labeled RESUPPLY is mounted above the alcove.

>rules
Rules tracing now switched on. Type "rules off" to switch it off again, or "rules all" to include even rules which do not apply.

* * *

 

 

Supply Room
You are standing in a spacious room made of reinforced concrete. A lighting panel illuminates the room in a tense white glow. There is another room to the SOUTH.

An alcove is carved into the wall in front of you. Hovering in the alcove are a SHIELD alloy, a BLADE alloy, an ENTROPIC alloy, a MEND alloy and a SPARK alloy.

A large red button labeled RESUPPLY is mounted above the alcove.

>zx
That's not a verb I recognise.

>x
(the table)
On the table is a mouse.

THAT table IS NOT SCENERY

>z
rate 5
That's not a verb I recognise.

* * *

 

 

Supply Room
You are standing in a spacious room made of reinforced concrete. A lighting panel illuminates the room in a tense white glow. There is another room to the SOUTH.

An alcove is carved into the wall in front of you. Hovering in the alcove are a SHIELD alloy, a BLADE alloy, an ENTROPIC alloy, a MEND alloy and a SPARK alloy.

A large red button labeled RESUPPLY is mounted above the alcove.

>zz
That's not a verb I recognise.

>z
THATS A LIGHT HAHAHA