test-project
An Interactive Fiction by Elliot Fiske
Release 1 / Serial number 160104 / Inform 7 build 6M62 (I6/v6.33 lib 6/12N) SD

cool

>look cool
You can't see any such thing.

>look self
As good-looking as ever.

>eat self
You're plainly inedible.

>wait
Time passes.

* * *

test-project
An Interactive Fiction by Elliot Fiske
Release 1 / Serial number 160104 / Inform 7 build 6M62 (I6/v6.33 lib 6/12N) SD

cool

>look room
You can't see any such thing.

>look at room
You can't see any such thing.

>die
That's not a verb I recognise.

>look self
As good-looking as ever.

* * *

>eat self
You're plainly inedible.

>punch self
Violence isn't the answer to this one.

>die
That's not a verb I recognise.

>kill self
Violence isn't the answer to this one.

>murder self
Violence isn't the answer to this one.

>jump
You jump on the spot.